開放世漢詞典

© 2013年 kaifangcidian.com
網址：http://www.kaifangcidian.com
本字典以創作共用“署名 3.0”許可協議授權發佈（詳見 http://creativecommons.org/licenses/by/3.0/）

［世界語］	［中文］

-eco	性
-ega	非常
-ema	趨向於
-ido	小
-ino	母，雌
-seksa	性
-u	應該
a.KE	公元前，西元前
abdomenaj muskoloj	腹肌
abdomeno	腹部，腹
abelejo	養蜂場
abelisto	養蜂人，養蜂家
abelkulturo	養蜂學，養蜂
abelo	蜜蜂
abelujo	蜂窩
abelvakso	蜂蠟
abiarbo	杉樹，杉
abio	杉樹，杉
abismo inter la generacioj	代溝
ablativa kazo	奪格
ablativo	奪格
aboco	字母表
abrikotarbo	杏樹
absinto	苦艾，歐洲艾
absoluta	絕對
absolute ne	決不
abstrakta	抽象
aĉa	爛
acerarbo	楓樹，楓
acero	楓，楓樹
aĉetanto	客戶
aĉeti	買
acida	酸
acida gusto	酸味
adampomo	喉結
adaptiĝi	適應
adiaŭ	再見，再會，別了
adiaŭa	離別的，告別的
adiaŭi	告別
adiaŭo	離別，告別
adjektiva finiĝo	形容詞詞尾
adjektivo	形容詞
administra	行政
administranto	經理
administri	管理
admiri	佩服
adori	崇拜，禮拜
adrenalino	腎上腺素
adreso	地址
adverbo	副詞
advokato	律師
aerarmeo	空軍
aerlinio	航空公司
aero	空氣
aerpoluo	空氣污染
aerpoŝto	航空郵件
afabla	親切
afero	事情
afikso	詞綴
afiŝo	海報
afiŝtabulo	廣告牌，佈告欄
Afrika Unio	非盟，非洲聯盟
Afrodito	阿佛洛狄忒
agado	活動
agema	主動
aglibero	活動的餘地，活動的空間
aglo	老鷹
ago	動作
aĝo	年齡
agrabla	愉快
agrikultura socio	農業社會
agrikulturo	農業
Aĥila tendeno	跟腱
aj!	很痛，很疼，好痛
aĵo	東西
akaciarbo	金合歡樹，金合歡
akacio	金合歡，金合歡樹
akĉento	腔
akcento	重音
akcentsigno	重音符號
akcepti	接受
akcidento	事故
akiri	得到
akra	銳利
akrido	蝗，蝗蟲
akronimo	首字母縮略詞，首字母縮略字
akselo	胳肢窩，腋窩，腋
aktinio	錒
aktiva	主動
aktiva participo	主動分詞
aktiva voĉo	主動語態
aktivo	主動語態
aktoro	演員
akurata	正確
akuzanto	原告
akuzativa kazo	直接受格，受格，賓格
akuzativo	直接受格，受格，賓格
akuzi	指控
akuzito	被告
akvario	水族館
akvero	水滴
akvifolio	冬青
akvo	水
akvofalo	瀑布
akvolilifloro	睡蓮花，睡蓮
akvolilio	睡蓮，睡蓮花
Akvostelo	水星
al	朝向，到，對
Alaho	阿拉，安拉
albordiĝejo	碼頭
albumo	唱片，專輯
aldoni	加上
alergia	過敏
alfabeto	字母表
alfronti	面對
algoj	水藻，藻類
alĝustigi	調整
alia	另一個，不同，另，別的，另一，另外一個
alie	否則，不然
aligatoro	短吻鱷，鱷
alilandano	外國人
alilando	外國
alko	麋鹿，麋
alkoholo	酒精，酒
alkutimiĝi	適應，習慣了，習慣於
allogi	吸引
almenaŭ	至少
almozpetulo	乞丐
almozulo	乞丐
alnarbo	榿，赤楊，榿木，赤楊樹，榿木樹
alno	榿木樹，榿木，赤楊，赤楊樹，榿
alofono	音位變體
aloo	蘆薈
alporti	帶來，帶領，帶去，帶
alta	喬，高，高大
altmaro	高潮
alto	身高
alttajdo	高潮
aluminio	鋁
alveni	到達，達，到
alveni malfrue	姍姍來遲
alveno	到來
amanto	情人
amara	苦
amara gusto	苦味
amarilidfloro	孤挺花
amarilido	孤挺花
ambasadorejo	大使館
ambasadoro	大使
ambaŭ	兩者
ambicia	自負
ambicio	抱負
ambrosifloro	豚草，豬草，豕草
ambrosio	豚草，豬草，豕草
ambulanco	救護車
americio	鎇
amfibio	兩棲動物
ami	愛
amiko	友，朋，朋友
aminda	可愛
Amnestio Internacia	國際特赦組織
amnia fluido	羊水
amnia likvaĵo	羊水
amo	愛情
amorveka	性感
ampolo	電燈泡
amuza	好玩
amuzado	樂趣
amuzaĵo	娛樂
amuzo	樂趣
anagramo	變位詞
analfabeta	不識字
analizi	分析
ananasarbo	鳳梨樹
anaso	鴨，鴨子
anĝelo	天使
angilo	鰻魚，鰻
angioj	血管
anglalingvaj landoj	英語系國家
angulo	角落，角度
Anhujo	皖，安徽
animo	靈魂，心靈
ankaŭ	也
ankoraŭ	還是，依舊，依然，仍然，尚，還，依，猶，猶然，照舊，仍，照樣
ankoraŭ ne	還沒，尚未
ano	成員
anonci	宣佈
anonco	廣告
ansero	鵝
anstataŭ	而非
anstataŭigi	代替
antaŭ	以前，前，之前
antaŭ de la Komuna Erao	公元前
antaŭ la komuna erao 	西元前
antaŭ nelonge	近來，最近
antaŭbrako	前臂
antaŭe	前面，以前
antaŭjuĝo	成見
antaŭmanĝaĵo	主菜
antaŭmendi	預訂
antaŭmolaro	前臼齒
antaŭo posten	前後顛倒，本末倒置
antaŭparolo	前言，序言
antaŭparto de kolo	頸
antaŭplano	前景
antaŭsento	預感
antaŭsigno	前兆，預兆
antaŭtagmeze	上午，早上
antaŭtuko	圍裙
antaŭurbo	郊區，郊外
antaŭvidi	預見，期待
anteno	天線
antikva	古老
antimatter	反物質
antimono	銻
antineŭtrono	反中子
antipartiklo	反粒子
antiprotono	反質子
antonimo	反義詞，反義字
aorto	大動脈，主動脈
aparataro	硬體
apartamento	公寓
aparteni al	屬於，屬
apenaŭ	幾乎不，差點沒有，勉強
apendico	闌尾
aperi	出現
apetito	胃口
aplaŭdi	拍手
apocino	毒狗草
Apolono	阿波羅
aprilo	四月
apro	野豬
apud	旁，旁邊
apuda	隔壁
Araba Ligo	阿拉伯聯盟，阿拉伯國家聯盟，阿盟
araba parolo	阿拉伯話
araba skribo	阿拉伯文
araneo	蜘，蛛，蜘蛛
aranĝi	安排
arbaro	森林
arbedo	矮樹
arbfolio	樹葉
arbitracianto	裁判
arbo	樹木
arboŝelo	樹皮
arbradiko	樹根
arbŝelo	樹皮
arbsuko	樹液
arbtrunko	樹幹
arekarbo	檳，檳榔樹
areko	檳，檳榔樹
Areso	戰神阿瑞斯，阿瑞斯
aresti	逮捕
arĝenta	銀
arĝentkolora	銀，銀色
arĝento	銀
argilo	黏土
argono	氬
aristokrataro	貴族政治
arkeologio	考古學
arkitekto	建築師
arma	武裝
arma konflikto	武裝衝突
armeo	陸軍
armilo	武器
aroma	香
aromo	香氣，口味
arseno	砷，砒
artaĵo	藝術品
artefarita satelito	衛星
Artemisa	阿爾忒彌斯
artemizio	艾草，艾
arterio	動脈
artiko	關節
artikolo	文，冠詞，文章
artisto	藝術家
arto	藝術
asekuro	保險
aserti	主張
asfalto	柏油
asfodelfloro	日光蘭，阿福花，日光蘭花
asfodelo	日光蘭，阿福花，日光蘭花
asklepiado	馬利筋
Asocio de Sudorient-Aziaj Nacioj	東南亞國家聯盟，東盟
aspekti	看起來
aspekti simile	看起來很像
aspekto	外表
astato	砹，砈
asterfloro	紫苑花，紫苑
astero	紫苑，紫苑花
asteroido	小行星
astro	星體，天體
astronaŭto	太空人
Atena	雅典娜
atendejo	等候室
atendi	等，等待
atenton	小心
atestanto	目擊者
atmosfera premo	氣壓
atoma nukleo	原子核
atomkerna centralo	核電廠，核能發電廠，核電站
atomkerna fisio	核分裂
atomkerno	原子核
atommaso	原子量
atomnumero	原子序數
atomo	原子
aŭ	或者，或
aŭdaci	膽敢
aŭdi	聽見，聽到
aŭgusto	八月
aŭriklo	心房
aŭskulti	聽
aŭskultilo	聽筒
aŭto	車子，車，車輛，汽車
aŭtobiografio	自傳
aŭtobus	公共汽車，巴，公車
aŭtobuso	公車
aŭtolitotrajno	臥車
aŭtolitvagonaro	臥車
aŭtomata	自動
aŭtomobilo	車子
aŭtonoma nerva sistemo	自主神經系統
aŭtonoma regiono	自治區
aŭtoro	作者
aŭtuno	秋，秋天
avantaĝo	好處
avara	吝嗇
avelarbo	榛，榛樹
aveno	燕麥
aventuristo	冒險家
aventuro	冒險
averaĝa	平均
averti	警告
averto	警告
avida	貪心
azalefloro	杜鵑花
azaleo	杜鵑花
azeno	驢子，驢
Azi-Pacifika Ekonomia Kunlaboro	亞太經合，亞洲太平洋經濟合作組織，亞太經合組織
babilejo	聊天室
babili	聊天，聊，談天兒，聊天兒，談天，談
bakforno	烤箱
bakisto	麵包師傅
Bakko	巴克斯
bakterio	細菌
balailo	掃把
baldaŭ	不久
baleno	鯨魚，鯨
balkono	陽臺
balo	舞會
balzama abiarbo	香脂冷杉
balzama abio	香脂冷杉
bambuo	竹，竹子
bananarbo	蕉，香蕉樹，芭蕉樹
banĉambro	浴室
bandaĝo	繃帶
bani sin	沐浴
banjano	榕，榕樹
bankalsono	泳褲
banko	銀行
bankuvo	浴缸
bano	沐浴
baobabarbo	猴麵包樹
baobabo	猴麵包樹
barakti	掙扎
barata parolo	印度話
barbo	胡，鬍子
barilo	柵欄
bario	鋇
basita sur	根據
bastono	拐杖
batalisto	戰士
batalvenki	戰勝
baza	基本
bazaro	市
bebo	小孩
bedaŭra	抱歉
bedaŭrinda	可惜，遺憾
bedaŭrinde	不幸地，遺憾地
begonifloro	秋海棠花，秋海棠
begonio	秋海棠花，秋海棠
bela	美，美麗
beladono	顛茄
beleta	漂亮
benko	板凳
berilio	鈹
berkelio	錇
bestaĉo	怪物
besto	動物
betularbo	樺樹，樺，白樺，白樺樹
betulo	白樺，白樺樹，樺，樺樹
bezoni	需要，要，需
bibliotekisto	圖書管理員
biblioteko	圖書館
bicepso	二頭肌
biciklo	單車，自行車，腳踏車
bieno	農場
biero	啤酒
bildero	像素
bildkarto	明信片
bildo	圖片
biliono	一萬億，兆，一兆，萬億
binara stelo	雙星
biokemia procezo	生化過程
biologia ĉelo	細胞
birdo	鳥
bismuto	鉍
blanka	白色，白
blanka libro	白皮書
blanka nano	白矮星
blanka sangoĉelo	白血球
blato	蟑螂，蟑
blogo	部落格，博客
bloketoj	積木
blua	藍色，藍
blua stelo	藍星
boaco	馴鹿
boato	船
bobelo	氣泡
bolpunkto	沸點
bombo	炸彈
bona	好
bongusta	好吃
bonŝanci	走運
bonŝanco	好運
bonvenigi	歡迎，迎接
bonvenigo	招呼，歡迎
bonvenon	歡迎！
bonvolu	請
borilo	鑽孔機
boro	硼
borso	股票市場，證券交易所
botelkukurbo	葫，葫蘆
botelo	瓶子
bovaĵo	牛肉
bovido	小牛
bovino	母牛
bovo	牛
brakhorloĝo	手錶
brako	胳臂，胳膊，臂，手臂，臂
brakringo	手鐲
brakseĝo	扶手椅
brakumi	擁抱
branĉo	樹枝，枝
brando	白蘭地
brazil-arbo	巴西紅木
bremsoj	剎車
bretaro	櫃櫥
briketoj	積木
brila	明亮
Brita Imperio	大英帝國
Brita Regnaro	英聯邦
bromo	溴
bronzo	青銅
brovo	眉，眉毛
brua	吵鬧
brulavertilo	火警
bruliga	滾燙
brulligno	薪柴
bruna	咖啡色
brusto	脯，胸脯，胸
bubalo	水牛
budhano	佛教徒
budhismo	佛教
Budho	佛，佛陀
bufo	蟾蜍，蜍，蟾
buĝeto	預算
burĝono	花蕾，蕾，苞，花苞
buŝkavo	口腔
buŝo	嘴，嘴巴，口
buŝtuko	餐巾
butero	奶油
butikaro	商場
butiko	店鋪
butikumi	買東西
butono	紐，紐扣，鈕，電鈕
ĉambro	房，房間
Ĉangĉuno	長春
Ĉangŝao	長沙
ĉapelo	冠，帽子
ĉapo	瓶蓋
ĉar	因為，既然
ĉasi	追趕
ĉe	在
cedrarbo	香柏，雪松樹，香柏樹，雪松
cedro	香柏，雪松，香柏樹，雪松樹
ĉefa	主要，主
ĉefministro	總理
ĉefo	老闆
ĉefpropozicio	主句
ĉefurbo	首都，京，都
ĉefverbo	主動詞
cejanfloro	矢車菊，矢車菊花
cejano	矢車菊花，矢車菊
ĉeko	支票
ĉela dividiĝo	細胞分裂
ĉela histo	細胞組織，蜂窩組織
ĉeldividiĝo	細胞分裂
ĉelkerno	細胞核
celo	目標
ĉelo	細胞
cemento	水泥
ĉemizo	襯衫
Ĉengduo	成都
ĉeno	鏈條，鏈子
cent	百，一百
cent mil	十萬
cent miliardo	千億，一千億
cent miliono	億，一億
centa	第一百
Centaŭro	人頭馬，半人馬
centoble	百倍，一百倍
centono	百分之一
centra	中
centra nerva sistemo	中樞神經系統
centro	中間，中心
cerba trunko	腦乾
cerbeto	小腦
cerbo	腦子，腦部
cerebelo	小腦
cerebro	大腦
ceremonio	儀式
cerio	鈰
ĉerizarbo	櫻，櫻桃樹
ĉerizfloro	櫻花
certa	確定
certe	一定，定
certigi	確定
cerumeno	耳垢
cervo	鹿
ĉesi	結束，停止
cetere	而且
ĉevalejo	馬廄，廄，馬棚，馬房
ĉevalido	小馬駒，小馬，駒，馬駒
ĉevalino	雌瑪，母馬
ĉevalo	馬，馬，馬
ĉevalpovo	馬力
cezio	銫
ĉi-tie	這邊，這裏，這兒，這邊兒
ĉi-tio	這個
ĉi-tio estas	這是
ĉi-tiu	這個，這種
ĉi-tiuj	這些
ĉia speco	哪種…都，每種
ĉiam	常，總是
ĉiamverda	常青，常綠
ĉiamverda arbaro	常青森林，常綠森林
ĉiamverda arbo	常綠樹，常青樹
Ĉiang Kai-ŝek	蔣介石
cico	乳頭
ĉie	到處
ĉielarko	彩虹
ĉielkorpo	天體
ĉielo	天，天空，天堂
cigaredo	煙，香煙
cigaro	雪茄
cigno	天鵝
cikatra histo	疤痕組織
cikatro	疤痕
Ciklopo	獨眼巨人
cikonio	白鶴
cikorio	菊苣
Ĉin-dinastio	秦朝
ĉina	華語，華，中，漢
ĉina hibiskfloro	朱槿，扶桑花
ĉina hibisko	朱槿，扶桑花
ĉina ŝako	象棋
ĉina signo	漢字，字
ĉina urbo Ŝanhajo	上海
cinamarbo	肉桂樹
cinamo	肉桂樹
cindro	灰
Ĉing-dinastio	清朝
Ĉinghajo	青海，青
ĉinia diantfloro	石竹，石竹花
ĉinia dianto	石竹，石竹花
Ĉinio	華，中，中國
ĉino	中國人
ĉio	一切
ĉioscia	無所不知
cipresarbo	柏樹，柏
cipreso	柏，柏樹
ĉirkaŭ	約，圍著，左右，圍繞著
ĉirkaŭi	圍繞著，圍著
ĉirkaŭiri	迴圈
cirko	馬戲團
cirkonstanco	情況
cirkonstancoj	狀況
citaĵo	引用文
citi	引用
citronarbo	檸檬樹
ĉiu	都，每，每個人，每個
ĉiufoje	每次
ĉiuj	每個人都，大家
ĉiumomente	隨時
civilizo	文明
Ĉongĉingo	重慶，渝
ĉu -os	會不會
ĉu bona?	好不好
ĉu eblas	能不能
ĉu estos	會不會
ĉu mi povas	能不能
ĉu mi rajtas	可不可以，我可不可以
ĉu povas	能不能
ĉu rajtas	可不可以
ĉu scipovas	會不會
ĉu vi povas	可不可以
ĉu vi scipovas	你會不會
ĉu vi scipovas ŝakludi?	你會不會下棋
ĉu...?	嗎？ 
daktilarbo	棗椰樹
daktilpalmo	棗椰樹
damo	后
danci	跳舞
danĝera	危險
danĝero	危險
danki	謝謝，謝
dankon	謝謝，謝了，謝
dateno	資訊
dativa kazo	與格
dativo	與格
datreveno	週年紀念日
datumo	資訊
daŭra	持久的
daŭri	繼續
daŭrigi	繼續
daŭrigota	待續
daŭro	長短
dazipedo	犰，犰狳，狳
dazipo	犰，犰狳，狳
de	從
de la komuna erao 	西元
debati	辯論
decembro	十二月
decidi	決定
decido	決定
Dedalo	代達羅斯
defendanto	辨護人
defii	挑戰
defio	挑戰
defluiga tubo	輸水管
dek	十
dek du	十二
dek kvar	十四
dek kvin	十五
dek kvin minutoj	十五分鐘
dek mil	一萬，萬
dek miliardo	一百億，百億
dek miliono	一千萬，千萬
dek minutoj	十分鐘
dek naŭ	十九
dek ok	十八
dek sep	十七
dek ses	十六
dek tri	十三
dek unu	十一
dek-dua	第十二
dek-kvara	第十四
dek-kvina	第十五
dek-naŭa	第十九
dek-oka	第十八
dek-sepa	第十七
dek-sesa	第十六
dek-tria	第十三
dek-unua	第十一
deka	第十
dekfoje	十次
deklari	表示
deklaro	聲明
deklinaciebla	可以變化詞尾，可以變格
deklinacio	格變化
dekoble	十倍
dekono	十分之一
Deksesa-Reĝlandoj	十六國
dekstre-maldekstre	左右
dekstro kaj maldekstro	左右
delfeno	海豚
deltoida muskolo	三角肌
deltoido	三角肌
demanda frazo	疑問句
demanda partikulo	疑問助詞
demandi	問，詢問，查詢
demando	問題
demandvorto	疑問詞
Demetera	得墨忒耳
demokratio	民主
demono	魔鬼
demonstrativo	指示代詞，指示詞
demonstri	示範
denove	再
densigi	濃縮
dentego	長牙，獠牙
dentisto	牙醫
dento	牙齒，牙，齒
dentobroso	牙刷
dentokarno	牙床，齒齦，齦，牙齦
dentokrono	齒冠
dentopasto	牙膏
dentopikilo	牙簽
dentoradiko	齒根
dentpikilo	牙簽
dentrado	齒輪
deoksiribonuklea acido	脫氧核糖核酸，去氧核糖核酸
dependi de	依靠
deprimita	沮喪
destino	命運，命
detala	詳細
detalo	細節
detektivo	偵探
detrui	毀滅
devena de	來自
deveni	來自，來源於，起源於
deveni de	來自，出生於
deveni el	來自
deveno	來源，起源
deverŝi	倒掉，濾掉
devi	必須，應該
devigi	逼迫
devizo	座右銘
devo	義務
devus	該，應，應該
dezerto	沙漠
deziregi	渴望
deziro	欲望，願望
diafragmo	橫隔膜
dialekto	方言
dialogo	會話
Diana	黛安娜
diantfloro	康乃馨，荷蘭石竹，荷蘭石竹花，康乃馨花
dianto	荷蘭石竹，康乃馨，荷蘭石竹花，康乃馨花
dieto	飲食
diferenco	差別
difinita artikolo	定詞
difino	定義
diftongo	複合母音，雙母音，復母音，雙母音
digesta sistemo	消化系統
digesti	消化
digesto	消化
digno	尊嚴
dika	厚，粗
dika intesto	大腸
dikega	肥胖
dikfingro	大拇指
diktatoro	獨裁
dimanĉo	星期日，星期天，日，禮拜天，禮拜日，周日
dinastio	朝代
Dinastio Ĉin	秦，秦朝
Dinastio Ĉing	清，清朝
Dinastio Ĝin	金，金朝
Dinastio Ĝoŭ	周，周朝
Dinastio Han	漢，漢朝
Dinastio Jŭan	元朝，元
Dinastio Ljaŭ	遼，遼
Dinastio Ming	明，明朝
Dinastio Ŝang	商，商朝
Dinastio Ŝja	夏，夏朝
Dinastio Song	宋朝，宋
Dinastio Suej	隋朝，隋
Dinastio Tang	唐朝，唐
dinosaŭro	恐龍
Dio	上帝
dioneo	捕蠅草
Dionizo	狄俄尼索斯
diplomiĝi	畢業
diplomo	文憑
direktanto	主任
direkti	指導
direktoro	主任
diri	告訴，表示，說
diserigebla	生物降解的，生物能分解的
diserigi	瓦解，分解
disfali	倒塌，崩潰
diskonto	折扣
diskuti	商量
disprozio	鏑
disputi	爭論，吵架
disrompi	打碎
distanco	距離
distingi	辨認，辨別
distrita	分心
disverŝi	溢出，流出
diveni	猜想
diversa	種種，綜合
diversaj	各種
dividi	分開
DNA	脫氧核糖核酸，去氧核糖核酸
do	所以，那麼
dogano	海關
doktoro	博士
dokumenta filmo	紀錄片
dokumento	文件
dolĉa	甜
dolĉa gusto	甜味
dolora	痛，疼
dolorigi	傷害
doloro	痛，痛苦，疼痛
domego	豪宅
dometo	別墅
domo	房子，房
donacema	慷慨
donaco	禮物
doni	給
doni al iu telefonvokon	給…打電話
dormĉambro	卧室
dormema	想睡
dormi	睡覺
dormo	睡眠
dorno	刺
dorso	背部，背
dosiero	檔案
dosierujo	文件夾
drako	龍
dramo	劇情片
dramserio	連續劇
drataro	配線，佈線，接線
drato	電線
dratprovizado	配線，佈線，接線
drattondilo	線材剪切機，線剪
drinkejo	酒吧
drinkemulo	酒鬼
drinki	喝酒
drinki alkoholon	喝酒
drinkulo	酒鬼
drogaĉoj	毒
drogemulo	毒蟲
drogoj	毒
drogvendisto	毒販，毒品販子
droni	溺水
du	二，兩
du mil	兩千
du miliardo	二十億
du miliono	兩百萬
du minutoj	兩分鐘
dua	第二
dua persono	第二人秤
dubi	懷疑
ducent	二百，兩百
ducent mil	二十萬
ducent miliono	兩億
dudek	廿，二十
dudek du	廿二，二十二
dudek kvar	廿四，二十四
dudek kvin	廿五，二十五
dudek kvin minutoj	二十五分鐘
dudek mil	兩萬
dudek miliono	兩千萬
dudek minutoj	二十分鐘
dudek naŭ	廿九，二十九
dudek ok	廿八，二十八
dudek sep	二十七，廿七
dudek ses	廿六，二十六
dudek tri	二十三，廿三
dudek unu	二十一，廿一
dudeka	第二十
dufoje	兩次
duiliono	萬億，一兆，兆，一萬億
dujara	二年生
dujara herbo	二年生草本
dukapa muskolo	二頭肌
dum	期間，時
dunaskitoj	雙胞胎
dunganto	僱主
dungi	雇用，雇，聘請
dungito	雇員，員工
duoble	兩倍
duodeno	十二指腸
duonhoro	半個鐘頭，半個小時
duonkondukanto	半導體
duono	一半，二分之一，半
duonvivo	半衰期
duonvokalo	半母音
duŝi sin	洗澡
ebena	平坦
ebenaĵo	平原，草原
eble	也不一定，不一定，可能，也許
ebleco	可能性
ebonarbo	烏木，黑檀木，黑檀樹，黑檀木樹，烏木樹
ebono	烏木樹，黑檀木樹，黑檀木，烏木，黑檀樹
ebria	喝醉了，醉了
ebrii	醉
ebriiĝi	喝醉
ebriulo	醉鬼
eburo	象牙
eĉ	連，尚且，尚，連…都
eĉ ne	都不
eĉ ne...	連…都不
eĉ pli	更
eĉ se	即使
eco	性質
Edipo	俄狄浦斯
eduko	教育
edzeco	婚姻
edziĝi	結婚
edziĝi kun...	跟…結婚
edziĝo	婚禮
edziniĝi	結婚
edziniĝo	婚禮
efektive	其實
efikeco	效率
efiko	作用，效果
egala	平等
ege	非常，要命
egoisma	自私
egoista	自大
eĥino	海膽
eĥo	回聲
ejnŝtejnio	鎄
ejo	地方
ekde	自從
ekinacfloro	紫錐花，錐光菊，紫錐菊，錐菊
ekinaco	錐菊，紫錐花，錐光菊，紫錐菊
ekipaĵo	設備
ekkuŝi	躺下
ekonomio	經濟，經
ekrano	螢幕，屏幕
ekscita	刺激
ekscitita	興奮
eksedziĝi	離婚
eksedziĝo	離婚
eksedziniĝi	離婚
ekskuzi sin	道歉
eksmoda	過時
eksperimento	試驗
eksperto	專家
ekspliki	解釋
eksplodi	爆炸
ekspozicio	博覽會，展覽會
ekstere	外面
eksterlanda	外國
eksterlandano	外國人
eksterna orela kanalo	外耳道
ekstra	額外
ekstrema	極端
ekstreme	非常
ekvilibro	平衡
ekvojaĝi	出發
ekzemple	譬如
ekzemplo	例子
ekzerckajero	練習簿
ekzisti	有，存在
el	出
eldonejo	出版社
eldoni	出版
eldono	版本
eleagno	茶棗花
eleagnofloro	茶棗花
elefanta dentego	象牙
elefanta ŝako	象棋
elefanto	大象，象，象
elekti	選擇
elekto	選擇
elektra	電
elektra butono	電鈕
elektra cirkvito	電子線路，電路
elektra izolilo	電絕緣體
elektra kampo	電場
elektra kurento	電流
elektra rezistanco	電阻
elektra ŝargo	電荷
elektra seĝo	電椅
elektra sonorilo	電鈴
elektra ventumilo	電扇
elektristo	電工
elektro	電，電力
elektromagneta kampo	電磁場
elektronika	電子
elektrono	電子
elementa lernejo	小學
elemento	元素
elfaro	成就
elirejo	出口
eliri	出去，出發，出
ellerni	掌握
ellitiĝi	起床
elmigri	移民
elparolado	發音
elparoli	發音
elparoligi	說出
elparolo	發音
elpenso	觀念
elporti	忍受
elsaluti	登出
elsendi	廣播
elspezi	花費，花
elspezo	收支
elspiri	吐氣
elŝuti	下載，下
eltrovi	發明
eltrovo	發明
eluzi	用盡，耗盡，用完
eluziĝi	磨損，耗損，消耗
eluzita	磨損了的，消耗了的
elveni	出來
elverŝi	倒出
emajlo	琺琅，琅，琺琅質，琺
embarasa	尷尬
embarasita	尷尬
embria histo	胚胎組織
embria trunka ĉelo	胚胎乾細胞
embrio	胚胎
emeritiĝi	退休
emfazi	強調
emi	趨向於
emo	趨勢，趨向
en	在，入
en ĉiu okazo	不管怎樣，無論如何
en la okazo se	萬一，如果是那樣的話
enciklopedio	百科
endokrina sistemo	內分泌系統
energio	能量
enhavebleco	容量
enhavo	內容
enirejo	入口
eniri	入
enkadrigi	框起來
enketo	調查
enklasigi	歸類
enlitiĝi	上床
enmigri	移民
enmiksiĝi en	干涉
enmiksiĝo	干擾
enoterfloro meza	待宵草，月見草
enotero meza	月見草，待宵草
enregistri	註冊
ensaluti	登入
enskribi	註冊
enŝlosi	上鎖
enspezo	收入
enspiri	吸入
entenaĵo	內容
entreprenisto	企業家
entuziasma	熱情
enveni	進來
enverŝi	倒進，倒入
enviciĝi	排隊
envii	羡慕
enzimo	酵素
epigloto	會厭軟骨，會咽，會咽軟骨，會厭
epoko	時代
erao	紀元
erari	犯錯
eraro	誤，錯，錯誤
erbio	鉺
erikfloro	石南花
eriko	石南花
erinaco	蝟，刺蝟
eritrocito	紅細胞，紅血球
ero	屑，粒，小組件
escepto	例外
eskalatoro	自動扶梯
eskapi	逃脫
Esperanto	世界語
esperi	希望
esprimi	表達
esprimo	術語，說法
esti	有
esti hejme	在家
esti miskomprenata	被誤解
esti nur	只是
estontaj generacioj	後代
estonteco	未來
estonto	未來
estro	領袖
etendi	膨脹
eterne	永遠
etfingro	小指
etikedo	標簽
eŭkaliptarbo	桉樹，桉
eŭkalipto	桉樹，桉
eŭkarioto	真核生物
eŭro	歐元
Eŭropa Liberala Demokrata Partio	歐洲自由民主與改革黨
Eŭropa Parlamento	歐洲議會
Eŭropa Popolpartio	歐洲人民黨
Eŭropa Unio	歐洲聯盟，歐盟
Eŭropaj Demokratoj	歐洲民主黨
eŭropio	銪
evidenta	明顯
eviti	逃避
evolui	發展
evoluigi	發展
evoluigita	發達
evoluo	進化
ezofago	食道
fabelo	童話故事，童話
fabo	蠶豆
fabrikejo	工廠
facila	易，不難，容易
facile	輕易
facilrompa	脆弱
fagarbo	山毛櫸，山毛櫸樹
fago	山毛櫸，山毛櫸樹
fajlilo	銼刀
fajraĵo	煙火
fajrejo	灶臺，爐邊
fajrero	火花，火星
fajrilo	打火機
fajro	火
fajropoto	火鍋
Fajrostelo	火星
fako	科目
fakte	其實
fakto	事實
fakulo	專家
falango	指骨
faldi	摺疊
falfolia	落葉
falfolia arbo	落葉樹
fali	落，掉了
fali suben	落下來
falko	鷹，隼，鵰
falŝa akaciarbo	洋槐樹，刺槐，刺槐樹
falŝa akacio	刺槐樹，洋槐樹，刺槐
fama	著名，有名，聞名
familia nomo	姓，姓氏，氏
familio	家人
famo	名
fantomo	鬼魂，鬼
farbo	顏料，染料
fari	製造，做
faringo	咽喉，咽
farmacio	藥房
farmisto	農人
farmo	農場
fazo de materio	物態，相，相態
febra	發燒的
febri	發高燒，發燒
febro	高燒
februaro	二月
fekaĵo	糞便，大便
fekaĵputo	糞坑，化糞池
feki	拉屎，大便
feko	糞便，大便
fekunda	肥沃
feliĉa	快樂，幸福
feliĉeco	幸福
feliĉo	幸福
femura arterio	股動脈
femuro	大腿
femurosto	大腿骨
fendaĵo	裂縫，裂口
fendi	分開，裂開
fendiĝi	分裂，迸裂
fenestro	視窗
fenestrokadro	窗框
fenikoptero	紅鶴
feniksino	凰
fenikso	鳳，鳳凰
fenomeno	現象
fera	鐵的，鐵制的
ferdeko	甲板
ferdrato	鐵線
ferio	假日
fermentinta toŭfuo	豆乳
fermi	關閉，閉，關
fermi la pordon	關門
fermio	鐨
fero	鐵
ferumi	釘蹄鐵
fervojo	鐵路
festeno	宴，宴會
festi	慶祝，過節
festo	節日，慶祝活動
feto	胎，胎兒
fi	可恥
fia	賤，下流，可恥的
fibro	纖維
fidi je	信任
fido	信仰，信賴
fiera	驕傲
fifama	臭名昭著，臭名遠揚，惡名昭彰
figarbeto	印度橡樹，印度榕，印度橡膠樹，印度榕樹
figarbo	無花果樹
fiinsektoj	害蟲
fikopii	抄襲
filiĉo	子
filikoplanto	羊齒
filmo	片，電影，片子
filo	子
filodendrono	蘗，喜林芋，黃蘗
filozofio	哲學
filozofo	哲學家
filtrilo	過濾器
finaĵo	詞尾
fine	終於，最後
finfine	終於
fingra osto	指骨
fingringo	頂針
fingro	手指，指
fingroartiko	指關節
fingropremaĵo	手印，指紋
fini	結束
finiĝo	詞尾
fipetola	不羈，肆無忌憚，無拘無束
fipetolemo	放肆，無拘無束
firakonto	下流的故事
fiŝo	魚
fiŝvergo	釣桿，釣魚桿
flamengo	紅鶴
flankokupo	嗜好
flava	黃，黃色
flava kupro	黃銅
flava nano	黃矮星
flava stelo	黃星
flegisto	護士
fleksebla	彈性
fleksio	詞形變化
fleo	梯牧草，貓尾草
floro	花朵，花
flua	流利
fluaĵo	流體
flughaveno	機場，飛機場
flugi	飛行
flugilo	翅，翼，翅膀
flugmaŝino	飛機
fluoro	氟
fluso	漲潮
fluto	長笛
Fobo	火衛一
foje	次
foko	海豹
folio	葉，葉子，樹葉
fonemo	音位，音素
fonetiko	語音學，發音學
fono	背景
fonologio	音韻學
fonto	來源
forgesi	忘記，忘
foriri	離，離開
forĵetaĵo	廢物
forĵeti	丟掉
forĵetindaĵo	廢物
forkuri	逃脫
formala	正式
formiko	螞蟻，蟻，螞
formo	形狀
formortinta	絕種
forno	爐竈，爐
forpreni	拿走
forsitifloro	連翹花，連翹
forsitio	連翹花，連翹
forta	強
forte	強烈
forto	力氣
forumo	論壇
forviŝi	擦掉
fosforo	磷
fosmaŝino	挖土機
foti	拍照
fotilo	照相機
foto	照片
fotografi	拍照
fotosintezo	光合作用
fraksenarbo	灰樹，梣樹，白蠟樹，梣
frakseno	白蠟樹，灰樹，梣樹，梣
francio	鈁
frapi	打
frapi sur la pordon	敲門
fraŭla	獨身
frazelemento	句子成分
frazero	片語，片語
frazo	片語，短語，句子，片語
fremda	陌生
fremdulo	陌生人
freneza	瘋狂
frenezulejo	瘋人院
frenezulo	瘋人，狂人，瘋子
freŝa	新鮮
fridujo	冰箱，電冰箱
fromaĝo	乳酪
frostigi	冰凍
frostigilo	冷凍庫
frostigita	冷凍
frotado	摩擦
froto	摩擦
frua	早
fruktarbo	果樹
frukto	水果
fruktodona	肥沃
frunta lobo	額葉
frunto	額，額頭
fuĝi	逃走
Fuĝjano	閩，福建
Fuĝoŭo	福州
fulmo	電，閃電
fulmotondro	雷電
fumi	吸，抽煙，抽，抽煙，吸煙
fumi cigaredon	抽煙
fumo	煙
fundo	基礎
funelo	漏鬥
funkcii	起作用
funkciigi	操作
funkcio	功能
furorlibro	暢銷書
furzi	放屁
furzo	屁
fuŝi	搞砸，弄糟，搞壞
fusilo	步槍
fuŝita	糟糕的，壞了的
fuŝkontakto	短路
fuŝpalpi	摸索，弄亂，摸弄
futura tempo	將來時
fuzio	核聚變，核融合
gado	鱈魚，鱈
gadolinio	釓
gaja	活潑
Gaja	蓋婭
gajni monon	賺錢
gala veziko	膽囊，膽
galaksio	星系
Galaksio	銀河系，銀河
galiumo	鎵
galveziko	膽，膽囊
gambo	腿
ĝangalo	叢林
Gansuo	甘，甘肅
ganto	手套
garantii	保證
ĝardeno	花園
gardisto	衛兵
gasigi	氣化
gaso	瓦斯，氣體
gastama	好客
gasti	做客
gasto	客人
gazeto	新聞報紙，報紙，報
gazono	草坪
geedziĝi	結婚
Ĝeĝjango	浙江，浙
gejo	同志
geko	壁虎
ĝemeloj	雙胞胎
gemo	寶石
ĝena	麻煩，煩
ĝenaĵo	麻煩
generacio	一代，代
ĝenerala asembleo	大會
Ĝenerala Relativeco	廣義相對論
ĝenerala sekretario	秘書長
Ĝenerala Sekretario de UN	聯合國秘書長
Ĝengĝoŭo	鄭州
Ĝenĝis Ĥano	成吉思汗
ĝeni	麻煩，打擾，煩
genitiva kazo	屬格
genitivo	屬格
geniulo	天才
geno	基因
ĝeno	麻煩
genro	性
ĝentila	客氣，禮貌
genuo	膝蓋
geografio	地理
gepardo	獵豹
gepatra lingvo	母語
geranifloro	老鸛草
geranio	老鸛草
germanio	鍺
gerundo	動名詞
gesto	手勢
ĝi	它
ĝia	它的
ĝia propra	它自己的
giganta	巨大
giganta sekvojo	世界爺樹，世界爺，巨杉，巨杉樹
giganta stelo	巨星
giganto	巨人
gimnastiko	體操
ĝin	它
Ĝin-dinastio	金朝
Ĝingis-Ĥano	成吉思汗
ginkarbo	銀杏樹
ginko	銀杏樹
gipso	石膏
ĝirafo	長頸鹿
ĝis	拜拜
ĝis la revido	再見
ĝis nun	目前為止
gitaro	吉他
Ĝjangŝjio	贛，江西
Ĝjangsuo	江蘇，蘇
Ĝjilino	吉，吉林
Ĝjinano	濟南
glacimonto	冰山
glacio	冰
gladilo	熨鬥
glandoj	腺
glaso	杯子，杯，玻璃杯
glaso da akvo	一杯水
glata	潤滑
glavingo	劍鞘
glavo	劍
glitveturilo	雪橇
globskribilo	圓珠筆
gluaĵo	膠水
glukozo	葡萄糖
glumarko	貼紙
glutea muskolo	大臀肌
gluteo	臀，臀部，屁股
gluti	吞
ĝoja	樂，高興
ĝojo	樂
goo	圍棋
gorĝa pomo	喉結
gorĝo	喉，喉嚨，嚨
Ĝoŭ-dinastio	周朝
gramatika esprimo	語法術語
gramatiko	文法，語法
granatarbo	石榴樹
granda	大
Granda Eksplodo	大爆炸
granda orcino	虎鯨
granda pando	大貓熊，大熊貓
grandeco	大小
grandparte de	大部分的
grandvalora	貴重
grapfruktarbo	葡萄柚樹
grasa	肥，胖
grasa histo	脂肪組織
grasdika	肥胖
grasega	肥胖
gratulon	恭喜
grava	重要，嚴重
graveco	重要性
gravega	非常重要
gravita kampo	重力場，引力場，萬有引力場
gravito	重力，引力，重力相互作用，萬有引力
greka parolo	希臘話
grilo	蟋蟀，蟋，蟀
griza	灰，灰色
grundo	土壤
gruo	鶴
grupeto	小組
grupigi	組
grupo	小組，團體
Gŭangdongo	粵，廣東
Gŭangŝjio	桂，廣西
ĝui	享，享受
Gujĝoŭo	黔，貴州
Gujjango	貴陽
gumarbo	印度榕樹，印度榕，印度橡膠樹，印度橡樹
gumo	橡皮擦
ĝusta	對，正確
ĝustigi	調整
gusto	口味，味，味道
gustumi	嘗，尝试
gvidi	指導
gvidisto	導游
Hadeso	哈迪斯
hafnio	鉿
Hajkou	海口
hajlero	雹石，冰雹
hajlo	冰雹
Hajnano	瓊，海南島，海南
halti	停止
Han-dinastio	漢朝
hanĉino	漢人
Hangĝoŭo	杭州
hara foliklo	毛囊
hararo	頭髮，發
Harbino	哈爾濱
harfoliklo	毛囊
harmonia	和諧
harmonio	和諧
haro	頭髮，發，一根頭髮，毛
harplektaĵoj	辮，辮子
haŭto	皮膚
haŭto	膚，皮，皮膚
haŭtveziketo	水皰
haveno	海港
havi	有
havi bonŝancon	走運
havi nur	只有
hazarda	偶然
Hebejo	河北，冀
hebrea parolo	希伯來話
hedero	常春藤
Hefejo	合肥
Hefesto	赫斐斯托斯
hegemonio	霸權
heĝo	灌木
Hejlongĝjango	黑，黑龍江
hejme	在家
hejmo	家
hejmtasko	作業，功課
helena mitaro	希臘神話
helena mitologio	希臘神話
heliantfloro	嚮日葵，葵花，葵
helianto	嚮日葵，葵，葵花
heliko	蝸牛，蝸
heliumo	氦
helpanto	幫手，助理
helpi	幫忙
helpo	幫助
helpverbo	助動詞
hemisfero	半球
hemoglobino	血紅素，血紅蛋白，血色素
Henano	河南，豫
hepato	肝臟，肝
Hera	希拉，天後希拉
Herakleo	海格力斯，希拉克勒斯
herbo	青草，草，草本
heredaĵo	遺產
heredanto	繼承人
heredi	繼承
Hermeso	赫耳墨斯
heroo	英雄
Hestia	赫斯提亞
hibiskfloro	木槿，槿
hibisko	槿，木槿
hidrargo	汞，水銀
hidrogeno	氫
hieraŭ	昨，昨天
higieno	衛生
hinduismo	印度教
hiperiko punktita	貫葉連翹
hipnoto	催眠術
hipofizo	腦垂腺
hipokampo	海馬
hipokaŝtanarbo	七葉樹，馬慄樹
hipokaŝtano	馬慄樹，七葉樹
hipopotamo	河馬
hirudo	蛭，螞蟥，水蛭，螞
hirundo	燕，燕子
hiskiamo	天仙子，莨菪
histo	組織
historio	史，歷史
histriko	豪豬
hobio	嗜好
hodiaŭ	今，今天
hogo	火鍋
holmio	鈥
homa korpo	軀，人體，身軀
homamaso	人群
homaro	人類
homo	人，人類
homportilo	擔架床
honesta	誠實
Honkongo	香港，港
Honkongo Speciala Administra Regiono	香港特別行政區
honta	慚愧
horaro	時間表，行程
hordeo	大麥
horizonto	地平線
horloĝeto	手錶
horloĝo	時鐘，鐘
hormona malekvilibro	荷爾蒙失衡
hormono	荷爾蒙
ĥoro	唱詩班，合唱團
horo	時，小時，鐘頭
hortensifloro	繡球花，洋繡球花，紫陽花，八仙花
hortensio	紫陽花，繡球花，八仙花，洋繡球花
hotelo	飯店
Hubejo	鄂，湖北
hufferi	釘蹄鐵
huffero	馬蹄鐵
hufo	蹄
Huhehaŭteo	呼和浩特
humida	潮濕
humoro	脾氣，心情
humura	幽默
humuro	幽默感
Hunano	湖南，湘
hundo	狗
iafoje	有時候
iam	曾經
ida	小
idaro	子，子孫，後代
ideala	理想
identa	相同
ideo	主意
ideografiaĵo	字
idiotisma esprimo	習慣用語
idiotismo	習慣用語，成語，習慣語
ido	子，孩子
idolo	偶像
ie ajn	哪裡都
igi	使，導致，令
iĝi	成，變，成為，變成
ignori	忽視
Ikaro	伊卡洛斯
ila kazo	工具格
ili	她們，他們，它們
ili mem	他們自己
ilia	她們的，他們的，它們的
ilia propra	它們自己的，她們自己的，他們自己的
ilin	他們，它們，她們
ilo	工具
iluziisto	魔術師
iluzio	幻覺
imagi	想象
imago	想象力
imamo	阿訇，訇
imiti	模仿
imperativa formo	命令式
imperativa frazo	命令語句
imperativa modo	祈使語氣，命令語氣
imperativo	祈使
imperiestro	帝，皇帝，皇
imperio	帝國
impona	給人深刻印象的，令人難忘的，令人印象深刻的
imposto	稅
impreso	印象
impulsiĝema	衝動
imuna sistemo	免疫系統
ina	陰性，母，女性，雌
ina fenikso	凰
ina genro	陰性
ina substantivo	陰性名詞
ina vorto	陰性詞
incizivo	門齒
indekso	索引
indikativo	陳述式
indikativo modo	直述語氣，陳述語氣，直說法
indio	銦
indo	價值
Indonezio	印尼，印度尼西亞
industrio	工業
infaneto	嬰兒，小孩
infano	孩子
infekta	傳染
infekti	感染
infero	地獄
infinitiva modo	不定式語氣
infinitiva verbo	動詞不定式
infinitivo	不定式
informaĵo	資料
informi	報導
informo	資料
inĝeniero	工程師
ingredienco	成分
injekto	註射
inkluzive	包括，包括
inkluzive de	包括，包括
inko	墨水
inkŝpruca presilo	噴墨印表機
ino	女人
inseksa	雌性，雌，女性
insekto	蟲，蟲子，昆蟲
insisti	堅持
inspiraĵo	靈感
inspiro	靈感
instiga kaŭzo	動機
instinkto	本性
instruado	教育
instrui	教書，教
instruisto	老師，師
instrumentala kazo	工具格
instrumentalo	工具格
instrumento	儀器
insulo	島嶼
insulti	侮辱
insulto	侮辱
intence	故意
intence aŭ senintence	有意無意
inter	之間
interbatiĝi	打架
interesa	有意思，有趣
interesega	很有意思
intereso	興趣
interjekcio	感嘆詞
intermeti	干涉
intermeto	干擾
Interna Mongolio	內蒙古，蒙
internacia	國際
Internacia Atom-Energia Agentejo	國際原子能機構
Internacia Banko por Rekonstruado kaj Disvolvado	國際復興開發銀行
internacia juro	國際法
Internacia Krima Kortumo	國際刑事法庭
internacia leĝo	國際法
Internacia Mona Fonduso	國際貨幣基金組織，國際貨幣基金
Internacia Movado de la Ruĝa Kruco kaj Ruĝa Krescento	國際紅十字與紅新月運動
internacia organizaĵo	國際組織
Internacia Organizo por Normigado	國際標準化組織
interne	裏面
interogativo	疑問代詞
interparolado	對話
interpunkcia signo	標點符號
interpunkcii	標點
interpunkcio	標點法
interreto	互聯網
interŝanĝi	交換
intesto	腸，大腸
intima	親
intuicio	直覺
investi	投資
inviti	邀請
io ajn	什麼都
iom da	一點兒，一點
iom da akvo	一點水，一點兒水
iom da mono	一點錢，一點兒錢
iomete	一點點
ipomefloro	喇叭花，牽牛花
ipomeo	喇叭花，牽牛花
iri	去
iridfloro	鳶尾花
iridio	銥
irido	鳶尾花
iriso	虹膜
Islama	回
islamano	清真教徒
islamo	伊斯蘭教，回教，清真教
iterbio	鐿
itrio	釔
iu ajn	誰都，任何
iu tago	一天，有一天
iufoje	有時候
iuj	一些，些
izola	孤立
izolilo	絕緣體
izotopo	同位素
ja	確，的確，確實
jaguaro	美洲豹
Jalta Konferenco	雅爾塔會議
ĵaluza	妒嫉
jam	已經，已
jam ne	不再
jam ne...	不再…了
januaro	一月
japana	和
japana parolo	日本話
Japanio	日本
jarcento	世紀
Jarcento de la Lumoj	啟蒙時代
jarlibro	年鑒，年刊
jaro	年
jasmenfloro	茉莉花，莉，茉，茉莉
jasmeno	茉莉花，莉，茉莉，茉
ĵaŭdo	星期四，周四，四，禮拜四
Jazono	伊阿宋
jenaj	下列
jes	是的
ĵeti pilkon	扔球
jido	意第緒語
Jinĉŭan	銀川
jodo	碘
Johana herbo	貫葉連翹
ju pli granda, des pli bona	越大越好
ju pli malgranda, des pli bona	越小越好
ju pli malmultaj, des pli bona	越少越好
ju pli multaj, des pli bona	越多越好
ju pli... des pli...	越…越…
Jŭan-dinastio	元朝
judismo	猶太教
juĝejo	法庭
juĝisto	法官
juglandarbo	核桃樹，胡桃樹
jugulara vejno	頸靜脈
julio	七月
juna	年輕
Junano	滇，雲南
junio	六月
juniperarbo	檜樹，檜木，杜松樹，檜，刺柏，檜木樹，刺柏樹，杜松
junipero	杜松樹，刺柏，檜樹，檜，檜木樹，檜木，刺柏樹，杜松
junko	燈心草
Junona	朱諾
junulo	青年
Jupitero	朱庇特，木星
jupo	裙子
ĵurio	陪審團
ĵuristo	陪審員
ĵurnalisto	新聞記者，記者
ĵurnalo	報紙
juro	法
ĵus	剛剛，剛，剛纔
justa	公平
justeco	正義
kablo	鋼索
kadmio	鎘
kadro	框架，結構，框
kafejo	咖啡廳，咖啡館
kafeterio	食堂
kafo	咖啡
kaĝo	籠子
Kaira Deklaracio	開羅宣言
kaj	且，與，同，而，而且，以及，和，及
kakto	仙人掌
kalafloro	馬蹄蓮花，白海芋，水芋花，海芋，荷蘭海芋，海芋花，水芋，馬蹄蓮，白海芋花
kalao	水芋花，水芋，海芋，白海芋，馬蹄蓮花，荷蘭海芋，白海芋花，馬蹄蓮，海芋花
kalcio	鈣
kalemburo	雙關語
kalendaro	曆，日曆
kalendulfloro	萬壽菊花，萬壽菊，金盞花
kalendulo	萬壽菊，金盞花，萬壽菊花
kalifo	回教主
kalifornio	鐦
kalio	鉀
kalkano	腳跟
kalkulilo	電腦
kalo	雞眼
kalsono	內褲
kamarado	同志
kameleono	變色龍
kamelifloro	茶花，山茶花
kamelio	山茶花，茶花
kamelo	駱駝，駝
kameno	壁爐
kamentubo	煙囪
kamforarbo	樟樹，樟
kamioneto	貨車
kamiono	卡車
kamomilfloro	甘菊花
kamomilo	甘菊花
kamparano	農民
kampodometo	別墅
kampulo	農人
kanabo	麻，大麻
kanalo	頻道，電臺
kandelingo	燭台
kandelo	蠟燭
kanino	犬齒
kano	蘆葦，蘆，葦
kanti	唱歌
kantisto	歌手
kanto	謠，歌曲
Kantono	廣州
kantstilo	腔
kapableco	能力
kapablo	能力
kapacitanco	電容
kapacito	容量
kapdoloro	頭痛
kaphararo	頭髮
kaphaŭteroj	頭皮屑
kapitulaci	投降
kapjesi	點頭
kapkuseno	枕頭
kapnei	搖頭
kapo	首，頭部，頭
kapro	山羊
kaptilo	陷阱
kaptuko	頭巾
kapturna	頭暈
kapturniga	令人暈眩，令人頭暈
karaktero	性
karbono	碳
kardiovaskula sistemo	心血管系統
kardo	薊
kariero	事業，生涯
kariofilo	丁香
karobarbo	稻子豆
karotida arterio	頸動脈
karpaj ostoj	腕骨
karpo	鯉，鯉魚
kartilago	軟骨
karto	地圖，卡片，片
kartono	硬紙板
karulino	女朋友
karulo	男朋友
kaŝita	隱
kasko	頭盔
kaŝludo	捉迷藏
kaŝtanarbo	慄子樹，慄樹
kastelo	城堡
kastoro	海狸
kata mento	貓薄荷
katastrofo	浩劫
katido	小貓
katino	母貓
kato	貓
katolikismo	天主教
kaŭĉukarbo	橡膠樹
kaŭĉuko	橡膠
kaŭri	蹲下
kaŭzi	導致
kaŭzo	原因，理由
kava	中空
kavetoj	酒窩
kavo	洞穴，窟，窿，洞，窟窿，腔，穴
kazino	賭場
kazo	格
KE	公元，西元
kelka	幾
kelkaj	幾個
kelkfoje	幾次
kelkoble	幾倍
kelo	地下室，地窖
kemia elemento	化學元素
kemia simbolo	化學符號
kemio	化學
kernofendado	核分裂
kernofrukto	核果
kesto	箱
kia	什麼樣，哪種
kia speco	哪種，哪一種
kial ne	為什麼不
kial?	為什麼
kialo	理由
kiam	時，的時候
kiam?	什麼時候
kie	哪裡
kiel	怎麼
kies	誰的
kinejo	電影院
kineta energio	動能
kio	哪個
kio?	什麼
kiom	多少
kiom aĝa	幾歲
kiom da	多少
kiom multa	多少
kioma horo estas?	幾點鐘？，幾點？
kirurgo	外科醫生
kisi	接吻，親嘴，吻，親，親親
kiu speco de	哪種
kiu?	誰
klara	清，清楚
klare	明明
klarigi	解釋
klarigo	說明
klasĉambro	教室
klavaro	鍵盤
klaviklo	鎖骨
klavo	鍵
klematidfloro	鐵線蓮花，鐵線蓮
klematido	鐵線蓮花，鐵線蓮
kliento	客戶，顧客
klimato	氣候
kloro	氯
klorofilo	葉綠素
kloroplasto	葉綠體
kloŝfloro	風鈴草，風鈴草花
knabino	女孩子
knabo	男孩子
koalo	無尾熊
kobalto	鈷
kobro	眼鏡蛇
kodo	密碼
kodumulo	黑客
kojlo	結腸
kojnodento	犬齒
kokaĵo	雞肉
kokcigo	尾骨
kokcinelo	瓢蟲
koketi	調情
kokido	小雞
kokino	母雞
koko	雞
kokosarbo	椰，椰子樹
kokso	髖骨，髖
kolĉeno	項鏈
kolegio	學院
kolera	生氣
koleregigi	氣死
kolerigi	惹生氣
kolero	氣
kolhararo	鬃，馬鬃，鬃毛
kolhararo de ĉevalo	馬鬃
kolo	脖，項，脖子，頸，頸項
kolombio = niobo	鈳
kolombo	白鴿
kolonio	殖民地
koloro	顏色
koltuko	圍巾
kombilo	梳子
komedio	喜劇
komenci	開始
komerci	做生意
komerco	商業
kometo	彗星，掃帚星
komforta	舒服
komitato	委員會
kompanio	公司
komparacia grado	比較級
komparativa adjektivo	比較級形容詞
komparativo	比較級
kompaso	指南針
kompati	同情
kompatinda	可憐
komplemento	補語
kompleza	親切
komplezema	親切
komplika	複雜
komplimento	恭維
kompoŝti	堆肥
kompoŝto	堆肥
komprenaĵo	概念
kompreneble	當然
kompreneco	理解力
kompreni	瞭解，懂，了，理解，會，明白
komputilo	電腦
komuniki	溝通
komuniko	溝通
komunismo	共產主義
komunumo	社區
Komunumo de Nacioj	英聯邦
koncedi	承認
koncepto	概念，觀念
koncerto	演唱會
kondiĉa frazo	條件句
kondiĉa modo	條件語氣
kondiĉa propozicio	條件從句
kondicionalo	條件語
kondiĉo	條件
kondukanto	導體
konduki	領導
konduktilo	導體
konduto	行為
konfesi	承認
konflikto	衝突
konfuzita	迷惑
koni	識，認，認識
konio makula	毒胡蘿蔔，毒堇
konjunkcio	連詞
konkurado	競爭
konkuri	競爭
konkurso	比賽
konscienco	良心
konscio	知覺，意識
konsenti	同意
konservema	保守
konsileto	提示，暗示
konsili	勸說，勸，相勸，勸告
konsilo	忠告
konsistigaĵo	成分
konsoli	安慰
konsonanta litero	輔音字母
konsonanto	輔音，子音
konstruaĵo	建築物
konstrui	建設
konsumanto	消費者
kontakti	聯繫到，聯絡上
kontakto	聯絡，聯繫
kontanto	現金
kontenta	滿意
kontentigi	滿足
kontinento	大陸
konto	賬戶
kontrakto	合约
kontraŭ	對面，對著
kontraŭdira	自相矛盾
kontraŭdiro	矛盾
kontraŭe	對面
kontraŭi	反對
kontraŭstarema	頑固，固執
kontraŭstari	抵抗
kontraŭulo	對手
kontribui	貢獻
kontroli	查看
konvena	合適
Konvencioj de Ĝenevo	日內瓦公約
konvinki	說服
kopii mane	抄寫
kopirajto	版權
kopulo	系詞
kora valvo	心瓣
korbato	心搏
korbeto	小籃子
korbo	籃子
korbopilko	籃球
kordo	繩子
kordoloro	心痛
korea skribo	韓文
Koreio	南韓
korekti	糾正
korelativa vorto	關聯詞
koridoro	走廊
korkokverkarbo	栓皮櫟，軟木橡樹
korkokverko	栓皮櫟，軟木橡樹
kornea	眼角膜
korniko	烏鴉，烏，鴉
kornusarbo	紅瑞木，山茱萸樹，山茱萸
kornuso	紅瑞木，山茱萸，山茱萸樹
koro	心臟，心
koronaria arterio	冠狀動脈
korpa kavo	腔
korpharo	毛
korplingvo	肢體語言
korpo	身，身體
korpremita	憂鬱
kortumo	法院，法庭
kosma spaco	太空
koŝmaro	魘，噩夢，惡夢，夢魘
koto	泥巴
kotonarbo	棉花，棉
kotono	棉花，棉布，棉
koverto	信封
kovrilo	蓋子
krabo	蟹，螃蟹，螃
kraĉaĵo	痰
krajono	錢幣
krajonpintigilo	削鉛筆器
kranio	顱，頭顱
kratagarbo	山楂，山查，查，楂
kratago	查，楂，山查，山楂
kravato	領帶
kredi	信，相信
kreditkarto	信用卡
kredito	信用
kreema	創意
krei	創造
kremo	奶油
kreskado	成長
kriegi	尖叫
krimulo	犯人
kripla	殘廢
kriptono	氪
Kristandemokratoj	基督教民主黨
kristano	基督教徒
kritiki	批評
krizantemfloro	菊花，菊
krizantemo	菊花，菊
krizo	危機
kroĉilo	鉤子
krokodilo	鱷魚，鱷
krom	除了…外，除了…以外，除，除了…之外，除外，除…外
krom se	除非
krome	再加上，而且，另
kromnomo	綽號
kromo	鉻
Krono	克洛諾斯
krono	冕，冠冕
krucmilitistoj	十字軍
krucmilitoj	十字軍東徵
kruela	殘忍
kruro	小腿，脛
kruta	陡峭
ksenono	氙
ksifio	旗魚
Kublaj Ĥano	忽必烈
kubuto	肘，手肘
kudrado	針線，針線活
kudraĵo	針線，針線活
kudrero	一針
kudri	縫紉，縫合
kudrilarkorbo	針線筐
kudrilarujo	針線盒
kudrilo	針
kudrilo kaj fadeno	針線
kudristino	女裁縫，針線工，做針線工的
kudrofadeno	縫紉線
kudromaŝino	縫衣機，縫紉機
kuglo	子彈
kuirejo	廚，廚房，出訪
kuirforno	爐竈
kuiristo	廚師
kuko	蛋糕
kukolo	鵑，杜鵑
kulero	湯匙
kulo	蠓蟲，小蟲
kulpa	有罪
kulpigi	指控，怪，責怪
kulpigito	被告
kulpiko	小蟲叮的包
kulturejo	農園
kulturkampo	農地
kulturo	文化
kun	跟
kundividi	分享
kune	一起
kuniga histo	結締組織
kuniklo	兔，兔子
kunlabori	合作
kunmetita vorto	複詞，複合詞
Kunmingo	昆明
kuntiriĝi	收縮
kunvenigi	帶來，使一道來
kunveno	會議
kupro	銅
kuracisto	醫生
kuraĝa	勇敢
kuraĝi	膽敢
kuraĝigi	鼓勵
kuraĝo	勇氣
kuriero	象
kuriumo	鋦
kurta cirkvito	短路
kurteno	窗廉
kuŝiĝi	躺下
kutima	平常
kutime	習慣了，通常，慣
kutimi	習慣，慣於
kutimo	風俗，習慣
kvadrata	正方形
kvadricepso	股四頭肌，四頭肌
kvalifiko	資格
kvalito	質，品質，質量
kvankam	雖然
kvar	四
kvar mil	四千
kvar miliardo	四十億
kvar miliono	四百萬
kvar minutoj	四分鐘
kvara	第四
kvarcent	四百
kvarcent mil	四十萬
kvarcent miliono	四億
kvardek	四十
kvardek du	四十二
kvardek kvar	四十四
kvardek kvin	四十五
kvardek kvin minutoj	四十五分鐘
kvardek mil	四萬
kvardek miliono	四千萬
kvardek minutoj	四十分鐘
kvardek naŭ	四十九
kvardek ok	四十八
kvardek sep	四十七
kvardek ses	四十六
kvardek tri	四十三
kvardek unu	四十一
kvardeka	第四十
kvarfoje	四次
kvarkapa muskolo	四頭肌，股四頭肌
kvaroble	四倍
kvaronhoro	一刻
kvarono	四分之一
kvarsigna ĉina esprimo	成語
kvarsigna idiotismo	成語
kvazaŭ	就像，就如
kverkarbo	櫟，橡，橡樹
kverko	橡樹，櫟，橡
kvieta	安靜
kvin	五
kvin mil	五千
kvin miliardo	五十億
kvin miliono	五百萬
kvin minutoj	五分鐘
kvina	第五
kvincent	五百
kvincent mil	五十萬
kvincent miliono	五億
kvindek	五十
kvindek du	五十二
kvindek kvar	五十四
kvindek kvin	五十五
kvindek mil	五萬
kvindek miliono	五千萬
kvindek naŭ	五十九
kvindek ok	五十八
kvindek sep	五十七
kvindek ses	五十六
kvindek tri	五十三
kvindek unu	五十一
kvindeka	第五十
kvinfoje	五次
kvinoble	五倍
kvinono	五分之一
la afrikansa	南非語
la afrikansa lingvo	南非語
la Aksaj Potencoj	軸心國
la albana	阿爾巴尼亞語
la albana lingvo	阿爾巴尼亞語
la Aliancanoj	同盟國
la angla	英語，英文
la angla lingvo	英文，英語
la araba	阿拉伯語，阿拉伯文，阿拉伯話
la araba lingvo	阿拉伯語，阿拉伯話，阿拉伯文
la aŭtuna ekvinokso	秋分
la bengala	孟加拉語
la bengala lingvo	孟加拉語
la birma	緬甸語
la birma lingvo	緬甸語
la Blanka Domo	白宮
la bulgara	保加利亞語
la bulgara lingvo	保加利亞語
la ĉeftero de Ĉinio	大陸，中國大陸
la ĉeĥa	捷克語
la ĉeĥa lingvo	捷克語
la Ĉiela Altaro	天壇
la Ĉin-dinastio	秦
la ĉina	中文，中國話，漢語
la ĉina lingvo	華語，漢語，中文，中國話
la ĉina parolo	中國話
la Ĉina Popola Respubliko	中國人民共和國
la Ĉina revolucio de 1911	辛亥革命
la ĉina urbo Ĉongĉingo	重慶
la ĉina urbo Tjanĝino	天津
la Ĉing-dinastio	清
la ĉinula lingvo	華語
la dana	丹麥語
la dana lingvo	丹麥語
la dek dua de aprilo	四月十二日，四月十二號
la dek dua de aŭgusto	八月十二號，八月十二日
la dek dua de decembro	十二月十二號，十二月十二日
la dek dua de februaro	二月十二號，二月十二日
la dek dua de januaro	一月十二日，一月十二號
la dek dua de julio	七月十二日，七月十二號
la dek dua de junio	六月十二日，六月十二號
la dek dua de majo	五月十二號，五月十二日
la dek dua de marto	三月十二號，三月十二日
la dek dua de novembro	十一月十二號，十一月十二日
la dek dua de oktobro	十月十二號，十月十二日
la dek dua de septembro	九月十二號，九月十二日
la dek kvara de aprilo	四月十四日，四月十四號
la dek kvara de aŭgusto	八月十四日，八月十四號
la dek kvara de decembro	十二月十四號，十二月十四日
la dek kvara de februaro	二月十四號，二月十四日
la dek kvara de januaro	一月十四日，一月十四號
la dek kvara de julio	七月十四日，七月十四號
la dek kvara de junio	六月十四號，六月十四日
la dek kvara de majo	五月十四日，五月十四號
la dek kvara de marto	三月十四號，三月十四日
la dek kvara de novembro	十一月十四號，十一月十四日
la dek kvara de oktobro	十月十四日，十月十四號
la dek kvara de septembro	九月十四日，九月十四號
la dek kvina de aprilo	四月十五號，四月十五日
la dek kvina de aŭgusto	八月十五日，八月十五號
la dek kvina de decembro	十二月十五日，十二月十五號
la dek kvina de februaro	二月十五號，二月十五日
la dek kvina de januaro	一月十五日，一月十五號
la dek kvina de julio	七月十五日，七月十五號
la dek kvina de junio	六月十五日，六月十五號
la dek kvina de majo	五月十五日，五月十五號
la dek kvina de marto	三月十五日，三月十五號
la dek kvina de novembro	十一月十五號，十一月十五日
la dek kvina de oktobro	十月十五日，十月十五號
la dek kvina de septembro	九月十五號，九月十五日
la dek naŭa de aprilo	四月十九日，四月十九號
la dek naŭa de aŭgusto	八月十九日，八月十九號
la dek naŭa de decembro	十二月十九號，十二月十九日
la dek naŭa de februaro	二月十九日，二月十九號
la dek naŭa de januaro	一月十九日，一月十九號
la dek naŭa de julio	七月十九號，七月十九日
la dek naŭa de junio	六月十九號，六月十九日
la dek naŭa de majo	五月十九日，五月十九號
la dek naŭa de marto	三月十九號，三月十九日
la dek naŭa de novembro	十一月十九日，十一月十九號
la dek naŭa de oktobro	十月十九號，十月十九日
la dek naŭa de septembro	九月十九日，九月十九號
la dek oka de aprilo	四月十八日，四月十八號
la dek oka de aŭgusto	八月十八日，八月十八號
la dek oka de decembro	十二月十八號，十二月十八日
la dek oka de februaro	二月十八號，二月十八日
la dek oka de januaro	一月十八號，一月十八日
la dek oka de julio	七月十八日，七月十八號
la dek oka de junio	六月十八日，六月十八號
la dek oka de majo	五月十八號，五月十八日
la dek oka de marto	三月十八號，三月十八日
la dek oka de novembro	十一月十八號，十一月十八日
la dek oka de oktobro	十月十八日，十月十八號
la dek oka de septembro	九月十八號，九月十八日
la dek sepa de aprilo	四月十七號，四月十七日
la dek sepa de aŭgusto	八月十七日，八月十七號
la dek sepa de decembro	十二月十七號，十二月十七日
la dek sepa de februaro	二月十七號，二月十七日
la dek sepa de januaro	一月十七日，一月十七號
la dek sepa de julio	七月十七日，七月十七號
la dek sepa de junio	六月十七日，六月十七號
la dek sepa de majo	五月十七日，五月十七號
la dek sepa de marto	三月十七日，三月十七號
la dek sepa de novembro	十一月十七日，十一月十七號
la dek sepa de oktobro	十月十七日，十月十七號
la dek sepa de septembro	九月十七號，九月十七日
la dek sesa de aprilo	四月十六號，四月十六日
la dek sesa de aŭgusto	八月十六號，八月十六日
la dek sesa de decembro	十二月十六日，十二月十六號
la dek sesa de februaro	二月十六號，二月十六日
la dek sesa de januaro	一月十六號，一月十六日
la dek sesa de julio	七月十六日，七月十六號
la dek sesa de junio	六月十六日，六月十六號
la dek sesa de majo	五月十六號，五月十六日
la dek sesa de marto	三月十六號，三月十六日
la dek sesa de novembro	十一月十六日，十一月十六號
la dek sesa de oktobro	十月十六號，十月十六日
la dek sesa de septembro	九月十六號，九月十六日
la dek tria de aprilo	四月十三號，四月十三日
la dek tria de aŭgusto	八月十三日，八月十三號
la dek tria de decembro	十二月十三號，十二月十三日
la dek tria de februaro	二月十三日，二月十三號
la dek tria de januaro	一月十三號，一月十三日
la dek tria de julio	七月十三日，七月十三號
la dek tria de junio	六月十三日，六月十三號
la dek tria de majo	五月十三日，五月十三號
la dek tria de marto	三月十三日，三月十三號
la dek tria de novembro	十一月十三號，十一月十三日
la dek tria de oktobro	十月十三號，十月十三日
la dek tria de septembro	九月十三號，九月十三日
la dek unua de aprilo	四月十一號，四月十一日
la dek unua de aŭgusto	八月十一號，八月十一日
la dek unua de decembro	十二月十一號，十二月十一日
la dek unua de februaro	二月十一號，二月十一日
la dek unua de januaro	一月十一日，一月十一號
la dek unua de julio	七月十一日，七月十一號
la dek unua de junio	六月十一號，六月十一日
la dek unua de majo	五月十一日，五月十一號
la dek unua de marto	三月十一日，三月十一號
la dek unua de novembro	十一月十一號，十一月十一日
la dek unua de oktobro	十月十一號，十月十一日
la dek unua de septembro	九月十一號，九月十一日
la dek-dua horo	十二點，十二點鐘
la dek-unua horo	十一點鐘，十一點
la deka de aprilo	四月十號，四月十日
la deka de aŭgusto	八月十日，八月十號
la deka de decembro	十二月十號，十二月十日
la deka de februaro	二月十號，二月十日
la deka de januaro	一月十日，一月十號
la deka de julio	七月十日，七月十號
la deka de junio	六月十號，六月十日
la deka de majo	五月十日，五月十號
la deka de marto	三月十號，三月十日
la deka de novembro	十一月十號，十一月十日
la deka de oktobro	十月十號，十月十日
la deka de septembro	九月十號，九月十日
la deka horo	十點鐘，十點
la destino	命
la dua de aprilo	四月二號，四月二日
la dua de aŭgusto	八月二日，八月二號
la dua de decembro	十二月二號，十二月二日
la dua de februaro	二月二號，二月二日
la dua de januaro	一月二日，一月二號
la dua de julio	七月二號，七月二日
la dua de junio	六月二日，六月二號
la dua de majo	五月二號，五月二日
la dua de marto	三月二日，三月二號
la dua de novembro	十一月二日，十一月二號
la dua de oktobro	十月二日，十月二號
la dua de septembro	九月二號，九月二日
la dua horo	兩點，兩點鐘
la dua mondmilito	第二次大戰，二戰，第二次世界大戰
la dudek dua de aprilo	四月二十二日，四月二十二號
la dudek dua de aŭgusto	八月二十二日，八月二十二號
la dudek dua de decembro	十二月二十二號，十二月二十二日
la dudek dua de februaro	二月二十二號，二月二十二日
la dudek dua de januaro	一月二十二號，一月二十二日
la dudek dua de julio	七月二十二日，七月二十二號
la dudek dua de junio	六月二十二號，六月二十二日
la dudek dua de majo	五月二十二日，五月二十二號
la dudek dua de marto	三月二十二日，三月二十二號
la dudek dua de novembro	十一月二十二號，十一月二十二日
la dudek dua de oktobro	十月二十二日，十月二十二號
la dudek dua de septembro	九月二十二日，九月二十二號
la dudek kvara de aprilo	四月二十四日，四月二十四號
la dudek kvara de aŭgusto	八月二十四日，八月二十四號
la dudek kvara de decembro	十二月二十四日，十二月二十四號
la dudek kvara de februaro	二月二十四號，二月二十四日
la dudek kvara de januaro	一月二十四日，一月二十四號
la dudek kvara de julio	七月二十四日，七月二十四號
la dudek kvara de junio	六月二十四號，六月二十四日
la dudek kvara de majo	五月二十四號，五月二十四日
la dudek kvara de marto	三月二十四日，三月二十四號
la dudek kvara de novembro	十一月二十四號，十一月二十四日
la dudek kvara de oktobro	十月二十四號，十月二十四日
la dudek kvara de septembro	九月二十四日，九月二十四號
la dudek kvina de aprilo	四月二十五日，四月二十五號
la dudek kvina de aŭgusto	八月二十五日，八月二十五號
la dudek kvina de decembro	十二月二十五日，十二月二十五號
la dudek kvina de februaro	二月二十五日，二月二十五號
la dudek kvina de januaro	一月二十五日，一月二十五號
la dudek kvina de julio	七月二十五日，七月二十五號
la dudek kvina de junio	六月二十五日，六月二十五號
la dudek kvina de majo	五月二十五日，五月二十五號
la dudek kvina de marto	三月二十五號，三月二十五日
la dudek kvina de novembro	十一月二十五號，十一月二十五日
la dudek kvina de oktobro	十月二十五日，十月二十五號
la dudek kvina de septembro	九月二十五日，九月二十五號
la dudek naŭa de aprilo	四月二十九號，四月二十九日
la dudek naŭa de aŭgusto	八月二十九號，八月二十九日
la dudek naŭa de decembro	十二月二十九號，十二月二十九日
la dudek naŭa de februaro	二月二十九日，二月二十九號
la dudek naŭa de januaro	一月二十九日，一月二十九號
la dudek naŭa de julio	七月二十九日，七月二十九號
la dudek naŭa de junio	六月二十九日，六月二十九號
la dudek naŭa de majo	五月二十九號，五月二十九日
la dudek naŭa de marto	三月二十九號，三月二十九日
la dudek naŭa de novembro	十一月二十九號，十一月二十九日
la dudek naŭa de oktobro	十月二十九日，十月二十九號
la dudek naŭa de septembro	九月二十九號，九月二十九日
la dudek oka de aprilo	四月二十八日，四月二十八號
la dudek oka de aŭgusto	八月二十八號，八月二十八日
la dudek oka de decembro	十二月二十八號，十二月二十八日
la dudek oka de februaro	二月二十八號，二月二十八日
la dudek oka de januaro	一月二十八日，一月二十八號
la dudek oka de julio	七月二十八號，七月二十八日
la dudek oka de junio	六月二十八號，六月二十八日
la dudek oka de majo	五月二十八號，五月二十八日
la dudek oka de marto	三月二十八日，三月二十八號
la dudek oka de novembro	十一月二十八日，十一月二十八號
la dudek oka de oktobro	十月二十八號，十月二十八日
la dudek oka de septembro	九月二十八號，九月二十八日
la dudek sepa de aprilo	四月二十七號，四月二十七日
la dudek sepa de aŭgusto	八月二十七號，八月二十七日
la dudek sepa de decembro	十二月二十七日，十二月二十七號
la dudek sepa de februaro	二月二十七號，二月二十七日
la dudek sepa de januaro	一月二十七號，一月二十七日
la dudek sepa de julio	七月二十七日，七月二十七號
la dudek sepa de junio	六月二十七號，六月二十七日
la dudek sepa de majo	五月二十七日，五月二十七號
la dudek sepa de marto	三月二十七號，三月二十七日
la dudek sepa de novembro	十一月二十七號，十一月二十七日
la dudek sepa de oktobro	十月二十七日，十月二十七號
la dudek sepa de septembro	九月二十七日，九月二十七號
la dudek sesa de aprilo	四月二十六號，四月二十六日
la dudek sesa de aŭgusto	八月二十六日，八月二十六號
la dudek sesa de decembro	十二月二十六日，十二月二十六號
la dudek sesa de februaro	二月二十六號，二月二十六日
la dudek sesa de januaro	一月二十六號，一月二十六日
la dudek sesa de julio	七月二十六日，七月二十六號
la dudek sesa de junio	六月二十六號，六月二十六日
la dudek sesa de majo	五月二十六號，五月二十六日
la dudek sesa de marto	三月二十六號，三月二十六日
la dudek sesa de novembro	十一月二十六日，十一月二十六號
la dudek sesa de oktobro	十月二十六號，十月二十六日
la dudek sesa de septembro	九月二十六號，九月二十六日
la dudek tria de aprilo	四月二十三日，四月二十三號
la dudek tria de aŭgusto	八月二十三日，八月二十三號
la dudek tria de decembro	十二月二十三日，十二月二十三號
la dudek tria de februaro	二月二十三號，二月二十三日
la dudek tria de januaro	一月二十三號，一月二十三日
la dudek tria de julio	七月二十三號，七月二十三日
la dudek tria de junio	六月二十三日，六月二十三號
la dudek tria de majo	五月二十三日，五月二十三號
la dudek tria de marto	三月二十三日，三月二十三號
la dudek tria de novembro	十一月二十三日，十一月二十三號
la dudek tria de oktobro	十月二十三號，十月二十三日
la dudek tria de septembro	九月二十三日，九月二十三號
la dudek unua de aprilo	四月二十一日，四月二十一號
la dudek unua de aŭgusto	八月二十一日，八月二十一號
la dudek unua de decembro	十二月二十一日，十二月二十一號
la dudek unua de februaro	二月二十一日，二月二十一號
la dudek unua de januaro	一月二十一號，一月二十一日
la dudek unua de julio	七月二十一號，七月二十一日
la dudek unua de junio	六月二十一日，六月二十一號
la dudek unua de majo	五月二十一號，五月二十一日
la dudek unua de marto	三月二十一號，三月二十一日
la dudek unua de novembro	十一月二十一號，十一月二十一日
la dudek unua de oktobro	十月二十一號，十月二十一日
la dudek unua de septembro	九月二十一號，九月二十一日
la dudeka de aprilo	四月二十號，四月二十日
la dudeka de aŭgusto	八月二十日，八月二十號
la dudeka de decembro	十二月二十號，十二月二十日
la dudeka de februaro	二月二十號，二月二十日
la dudeka de januaro	一月二十號，一月二十日
la dudeka de julio	七月二十日，七月二十號
la dudeka de junio	六月二十號，六月二十日
la dudeka de majo	五月二十號，五月二十日
la dudeka de marto	三月二十號，三月二十日
la dudeka de novembro	十一月二十號，十一月二十日
la dudeka de oktobro	十月二十號，十月二十日
la dudeka de septembro	九月二十號，九月二十日
la duoblo de	一倍
la epoko de Klerismo	啟蒙時代
la estona	愛沙尼亞語
la estona lingvo	愛沙尼亞語
la eŭska	巴斯克語
la eŭska lingvo	巴斯克語
la fandujo granda	大熔爐
la filipina	菲律賓話，菲律賓語
la filipina lingvo	菲律賓語，菲律賓話
la finna	芬蘭語
la finna lingvo	芬蘭語
la Flava Rivero	黃河，河
la franca	法文，法語
la franca lingvo	法語，法文
la gaela	蓋爾語
la gaela lingvo	蓋爾語
la gardisto	士，仕
la Ĝenerala Asembleo de UN	聯合國大會
la generalo	將，帥
la germana	德文，德語
la germana lingvo	德文，德語
la Ĝin-dinastio	金，晉
la Ĝoŭ-dinastio	周
la Granda Muro	萬里長城，長城
la greka	希臘文，希臘語，希臘話
la greka lingvo	希臘語，希臘文，希臘話
la Han-dinastio	漢
la hanĉina lingvo	漢語
la hebrea	希伯來話，希伯來語，希伯來文
la hebrea lingvo	希伯來文，希伯來語，希伯來話
la Heĝiro	回教紀元
la hindia	印地語，印度話
la hindia lingvo	印地語，印度話
la hispana	西班牙文，西班牙語
la hispana lingvo	西班牙語，西班牙文
la hungara	匈牙利語
la hungara lingvo	匈牙利語
la indonezia	印尼語，印尼文
la indonezia lingvo	印尼文，印尼語
la insulo Hajnano	海南島
la insulo Tajvano	臺灣
la Internacia Kortumo de Justeco	國際法庭，國際法院
la Interreto	網際網路
la irlanda	愛爾蘭語
la irlanda lingvo	愛爾蘭語
la Islama kalendaro	回歷
la islanda	冰島語
la islanda lingvo	冰島語
la itala	義大利語
la itala lingvo	義大利語
la Jangzio-rivero	江，長江
la japana	日本話，日語，日文
la japana lingvo	日語，日本話，日文
la jida	意第緒語
la jida lingvo	意第緒語
la Jŭan-dinastio	元
la kantona	廣東話
la kantona lingvo	廣東話，粵語，廣州話
la kimra	威爾士語
la kimra lingvo	威爾士語
la klasika ĉina	文言文
la klasika ĉina lingvo	文言文
la Komuna Erao	公元
la komuna parolo	普通話
la Komunista Partio de Ĉinio	黨，中共，中國共產黨
la Korano	古蘭經
la korea	南韓語，朝鮮文，韓語，韓文，朝語，朝鮮語，南韓話，朝鮮話
la korea lingvo	朝鮮話，韓語，朝語，南韓語，南韓話，朝鮮文，朝鮮語，韓文
la kroata	克羅埃西亞語
la kroata lingvo	克羅埃西亞語
la kvara de aprilo	四月四號，四月四日
la kvara de aŭgusto	八月四日，八月四號
la kvara de decembro	十二月四日，十二月四號
la kvara de februaro	二月四號，二月四日
la kvara de januaro	一月四號，一月四日
la kvara de julio	七月四號，七月四日
la kvara de junio	六月四日，六月四號
la kvara de majo	五月四日，五月四號
la kvara de marto	三月四號，三月四日
la kvara de novembro	十一月四日，十一月四號
la kvara de oktobro	十月四日，十月四號
la kvara de septembro	九月四日，九月四號
la kvara horo	四點，四點鐘
la kvina de aprilo	四月五日，四月五號
la kvina de aŭgusto	八月五日，八月五號
la kvina de decembro	十二月五日，十二月五號
la kvina de februaro	二月五號，二月五日
la kvina de januaro	一月五號，一月五日
la kvina de julio	七月五號，七月五日
la kvina de junio	六月五號，六月五日
la kvina de majo	五月五號，五月五日
la kvina de marto	三月五日，三月五號
la kvina de novembro	十一月五日，十一月五號
la kvina de oktobro	十月五號，十月五日
la kvina de septembro	九月五號，九月五日
la kvina horo	五點，五點鐘
la laosa	寮國語，寮語
la laosa lingvo	寮語，寮國語
la latina lingvo	拉丁文
la latva	拉脫維亞語
la latva lingvo	拉脫維亞語
la litova	立陶宛語
la litova lingvo	立陶宛語
la Ljaŭ-dinastio	遼
la makedona	馬其頓語
la makedona lingvo	馬其頓語
la malagasa	馬達加斯加語
la malagasa lingvo	馬達加斯加語
la malaja	馬來文，馬來語
la malaja lingvo	馬來語，馬來文
la Malvarma milito	冷戰
la maoria	毛利語
la maoria lingvo	毛利語
la Meza Regno	中國
La Mezepoko	中世紀
la mia	我的
la Ming-dinastio	明
la mongola	蒙古話，蒙古語，蒙古文
la mongola lingvo	蒙古語，蒙古文，蒙古話
la nacia lingvo	國語
la nagaria skribo	天城文
la naŭa de aprilo	四月九日，四月九號
la naŭa de aŭgusto	八月九日，八月九號
la naŭa de decembro	十二月九號，十二月九日
la naŭa de februaro	二月九號，二月九日
la naŭa de januaro	一月九日，一月九號
la naŭa de julio	七月九日，七月九號
la naŭa de junio	六月九日，六月九號
la naŭa de majo	五月九號，五月九日
la naŭa de marto	三月九號，三月九日
la naŭa de novembro	十一月九號，十一月九日
la naŭa de oktobro	十月九號，十月九日
la naŭa de septembro	九月九日，九月九號
la naŭa horo	九點，九點鐘
la nederlanda	荷蘭文，荷蘭語
la nederlanda lingvo	荷蘭語，荷蘭文
la nepala	尼泊爾語
la nepala lingvo	尼泊爾語
la nia	我們的
la Nobelpremio	諾貝爾獎
la Nobelpremio por literaturo	諾貝爾文學獎
la norvega	挪威語
la norvega lingvo	挪威語
la oficista lingvo	官話
la oka de aprilo	四月八日，四月八號
la oka de aŭgusto	八月八日，八月八號
la oka de decembro	十二月八號，十二月八日
la oka de februaro	二月八號，二月八日
la oka de januaro	一月八號，一月八日
la oka de julio	七月八號，七月八日
la oka de junio	六月八日，六月八號
la oka de majo	五月八號，五月八日
la oka de marto	三月八日，三月八號
la oka de novembro	十一月八號，十一月八日
la oka de oktobro	十月八日，十月八號
la oka de septembro	九月八日，九月八號
la oka horo	八點，八點鐘
la olimpia flago	奧運會會旗
la Olimpiaj ludoj	奧林匹克運動會，奧運會，奧運
la Pakto Ribbentrop-Molotov	蘇德互不侵犯條約
la palia lingvo	巴利語
la pekina parolo	北京話
la perioda tabelo de la elementoj	元素周期表
la persa	波斯文，波斯語
la persa lingvo	波斯語，波斯文
la plejparto	大部分，大多數
la plejparto de	大部分的，一般的
la pola	波蘭語
la pola lingvo	波蘭語
la portugala	葡萄牙語，葡萄牙文
la portugala lingvo	葡萄牙文，葡萄牙語
la printempa ekvinokso	春分
la Renesanco	文藝復興
la Respubliko de Ĉinio	中華民國
la Reto	網際網路
la romano "Pilgrimo al la Okcidento"	西游記
la rumana	羅馬尼亞語
la rumana lingvo	羅馬尼亞語
la rusa	俄語，俄羅斯語，俄文
la rusa lingvo	俄語，俄羅斯語，俄文
la Ŝang-dinastio	商
la sanskrita lingvo	梵語，梵文
la Sekureca Konsilio de UN	聯合國安全理事會，聯合國安理會，安理會
la sepa de aprilo	四月七日，四月七號
la sepa de aŭgusto	八月七日，八月七號
la sepa de decembro	十二月七日，十二月七號
la sepa de februaro	二月七號，二月七日
la sepa de januaro	一月七日，一月七號
la sepa de julio	七月七號，七月七日
la sepa de junio	六月七號，六月七日
la sepa de majo	五月七號，五月七日
la sepa de marto	三月七日，三月七號
la sepa de novembro	十一月七號，十一月七日
la sepa de oktobro	十月七日，十月七號
la sepa de septembro	九月七號，九月七日
la sepa horo	七點鐘，七點
la serba	塞爾維亞語
la serba lingvo	塞爾維亞語
la sesa de aprilo	四月六日，四月六號
la sesa de aŭgusto	八月六日，八月六號
la sesa de decembro	十二月六號，十二月六日
la sesa de februaro	二月六號，二月六日
la sesa de januaro	一月六號，一月六日
la sesa de julio	七月六日，七月六號
la sesa de junio	六月六日，六月六號
la sesa de majo	五月六日，五月六號
la sesa de marto	三月六號，三月六日
la sesa de novembro	十一月六號，十一月六日
la sesa de oktobro	十月六日，十月六號
la sesa de septembro	九月六號，九月六日
la sesa horo	六點，六點鐘
la Sinhaja revolucio	辛亥革命
la Ŝja-dinastio	夏
la slovaka	斯洛伐克語
la slovaka lingvo	斯洛伐克語
la Somera Palaco	頤和園
la Song-dinastio	宋
la Ŝu-Reĝlando	蜀
la Suej-dinastio	隋
la sumera solstico	夏至
la svahila	斯瓦希里語
la svahila lingvo	斯瓦希里語
la sveda	瑞典語
la sveda lingvo	瑞典語
la taja	泰國語，泰文，泰語
la taja lingvo	泰國語，泰文，泰語
la tamila	泰米爾語
la tamila lingvo	泰米爾語
la Tang-dinastio	唐
la Terakota Legio de Qin-dinastio	兵馬俑
la tibeta	藏語，藏文
la tibeta lingvo	藏語，藏文
la Titanoj	提坦巨神，泰坦
la Tri Gorĝoj	三峽
la Tri Gorĝoj de Jangzio-Rivero	三峽
la tria de aprilo	四月三日，四月三號
la tria de aŭgusto	八月三日，八月三號
la tria de decembro	十二月三日，十二月三號
la tria de februaro	二月三號，二月三日
la tria de januaro	一月三號，一月三日
la tria de julio	七月三日，七月三號
la tria de junio	六月三日，六月三號
la tria de majo	五月三號，五月三日
la tria de marto	三月三號，三月三日
la tria de novembro	十一月三日，十一月三號
la tria de oktobro	十月三號，十月三日
la tria de septembro	九月三日，九月三號
la tria horo	三點鐘，三點
la tridek unua de aŭgusto	八月三十一號，八月三十一日
la tridek unua de decembro	十二月三十一日，十二月三十一號
la tridek unua de januaro	一月三十一日，一月三十一號
la tridek unua de julio	七月三十一日，七月三十一號
la tridek unua de majo	五月三十一日，五月三十一號
la tridek unua de marto	三月三十一日，三月三十一號
la tridek unua de oktobro	十月三十一號，十月三十一日
la trideka de aprilo	四月三十日，四月三十號
la trideka de aŭgusto	八月三十日，八月三十號
la trideka de decembro	十二月三十日，十二月三十號
la trideka de januaro	一月三十日，一月三十號
la trideka de julio	七月三十號，七月三十日
la trideka de junio	六月三十號，六月三十日
la trideka de majo	五月三十日，五月三十號
la trideka de marto	三月三十號，三月三十日
la trideka de novembro	十一月三十號，十一月三十日
la trideka de oktobro	十月三十日，十月三十號
la trideka de septembro	九月三十日，九月三十號
la turka	土耳其文，土耳其語
la turka lingvo	土耳其語，土耳其文
la tuta	整個，整
la Ŭej-Reĝlando	魏
la ukraina	烏克蘭語
la ukraina lingvo	烏克蘭語
la Universala Deklaracio de Homaj Rajtoj	世界人權宣言
la unua de aprilo	四月一日，四月一號
la unua de aŭgusto	八月一號，八月一日
la unua de decembro	十二月一日，十二月一號
la unua de februaro	二月一日，二月一號
la unua de januaro	一月一號，一月一日
la unua de julio	七月一日，七月一號
la unua de junio	六月一號，六月一日
la unua de majo	五月一日，五月一號
la unua de marto	三月一號，三月一日
la unua de novembro	十一月一號，十一月一日
la unua de oktobro	十月一號，十月一日
la unua de septembro	九月一日，九月一號
la unua horo	一點，一點鐘
La Unua Imperiestro de la Dinastio Qin	秦始皇
la unua mondmilito	第一次大戰，第一次世界大戰，一戰
la urdua lingvo	烏爾都語
la Ŭu-Reĝlando	吳
La Verdaj	歐洲綠黨
la via	你們的，你的
la vintra solstico	冬至
la vjetnama	越南語，越南話，越南文
la vjetnama lingvo	越南文，越南語，越南話
la zulua	祖魯語
la zulua lingvo	祖魯語
laboranto	工人
laboratorio	實驗室
laborejo	工作場所
labori	打工，工作
laboro	工，工作，勞動
laburnfloro	金鏈花
laburno	金鏈花
laca	累
lacerto	蜥，蜴，蜥蜴
ladskatolo	罐頭
lageto	水池，池塘
Lakta vojo	銀河系
laktodento	乳齒
laminario	藻，海藻
lampo	電燈，燈
lanco	長槍
landlimo	邊境
lando	國家，國
lango	舌，舌頭
Lanĝoŭo	蘭州
lano	羊毛
lantano	鑭 
lapo	牛蒡子，牛蒡，大力子，蒡
larĝa	廣，寬
larikarbo	落葉松，落葉松樹
lariko	落葉松，落葉松樹
laringo	喉頭，喉
larmi	流眼淚，流淚
larmo	淚，眼淚，淚水
Lasao	拉薩
lasera presilo	激光印表機
lasero	激光
lasi	讓
lastatempe	近來，最近
Latino	拉丁文
laŭ	照，據，按照，按
laŭ mia scio	據我所知
laŭdi	贊美
laŭdire	所謂
laŭleĝa	合法
laŭrarbo	月桂樹
laŭrencio	鐒
laŭro	月桂樹
laŭtparolilo	喇叭
laŭvorta	字面
lavejo	洗手間
lavendfloro	薰衣草
lavendo	薰衣草
leciono	課
ledo	皮，皮革，革
leganto	讀者
legendo	傳奇
legi	讀，看書，讀書
leĝo	法律，法
lekantfloro	雛菊，雛菊花
lekanto	雛菊，雛菊花
lemno	萍，浮萍
leonfaŭkfloro	龍嘴花
leonfaŭko	龍嘴花，金魚草
leono	獅子，獅
leontodfloro	蒲公英花，蒲公英
leontodo	蒲公英花，蒲公英
leopardo	花豹
lernantaro	班
lernanto	學生
lernejestro	校長
lernejo	學校
lerni	學習
lernolibro	課本
lerta	聰明
lerteco	技巧
leterkesto	信箱
letero	信
leterportisto	郵差
leviĝi	起來，上升
li	他
li mem	他自己
lia	他的
lia propra	他自己的
libelo	螞螂，蜓，蜻蜓，螞，蜻
libera	有空
Libera Eŭropa Alianco	歐洲自由陣線聯盟
liberala	開放
libereco	自由
liberigi	釋放
libro	書，書本，一本書
librovendejo	書店
liĉiarbo	荔，荔枝樹
lieno	脾臟，脾
lifto	電梯
ligamento	韌帶
lignero	碎片，木刺
ligno	木材，木頭
lignokarbo	木炭
Lignostelo	木星
Ligo de Arabaj Ŝtatoj	阿拉伯聯盟，阿拉伯國家聯盟，阿盟
Ligo de Nacioj	國際聯盟，國聯
likeno	地衣
likvaĵo	液體
likvigi	液化
likvo	液體
lilifloro	百合，百合花
lilio	百合，百合花
limako	鼻涕蟲
limearbo	萊姆樹
limfa glando	淋巴腺
limfo	淋巴
limfonodo	淋巴結
limigi	限制
limigita	有限
lin	他
lingvistiko	語言學
lingvo	語言，文，語
linko	猞，猁，猞猁
lino	亞麻
lipharo	鬍子
lipo	嘴唇
listigi	列出
listo	名單
listo de kantoj	曲目
lita superkovrilo	被單，床罩
litaĵo	被褥，鋪蓋
lite	在床上
literaturo	文學
litero	字母
literumi	拼字
litio	鋰
litkadro	床架
litkovrilo	被子，毛毯
litkuseno	枕頭
litmalsana	臥床不起
lito	床，床鋪
littuko	床單
litvagono	臥鋪車，臥車
livio	鴿，鴿子
Ljaŭ-dinastio	遼
Ljaŭningo	遼，遼寧
loĝantaro	人口
loĝanto	居民
loĝejo	住宅
loĝi	居住
loĝi ĉe 	住在
logiko	邏輯
lokativa kazo	地格
lokativo	地格
loko	地方，場所
lokusto	蜢，蚱，蚱蜢
loligo	烏賊
longa	長
longa fingro	中指
longatempe	久，好久，很久，久久
longdaŭra	長期
longdistanca	長途
longeco	長度，長短
longtempa	長期
longtempe	久，好久，很久，久久
lonicero	忍冬
loterio	彩券
lotusfloro	荷花，芙蓉，芙蓉花，蓉，芙，蓮，荷，蓮花
lotuso	芙，荷花，荷，蓮花，芙蓉花，蓉，蓮，芙蓉
luanto	房客
ludi	玩，扮演，玩游戲
ludi tabulludon	對弈
ludilo	玩具
ludo	游戲
luebla	出租
lui	租用
lui de	租用
luigi	租出
lukontrakto	租約
lukti	掙扎
luktosporto	武術
lulilo	搖籃
lulkanto	搖籃曲
lum-ampolo	電燈泡
luma	明亮
lumdisko	光碟，光碟
lumjaro	光年
lumo	光
lumrapido	光速
lumturo	燈塔
lundo	一，禮拜一，星期一，周一
luno	月亮，月
Luno	月球
lupago	租金
lupo	狼
lutecio	鑥，鎦
lutro	獺，水獺
luzerno	紫花苜蓿，紫苜蓿
magazeno	百貨公司
magio	魔法
magneta disko	磁碟
magneta kampo	磁場
magneto	磁鐵
magnetofono	錄音機
magnetoskopo	錄影機
magnezio	鎂
magnolifloro	玉蘭，玉蘭花
magnolio	玉蘭花，玉蘭
mahagono	桃花心木
maizo	玉米
majo	五月
Makao	澳，澳門
makropo	袋鼠
makzelo	顎，頜
malakra	遲鈍
malalta	矮小，低
malaltmaro	低潮
malalttajdo	低潮
malami	仇恨，憎恨，討厭
malamika	敵對的，敵意的
malamikeco	敵意
malamiko	仇人，敵人
malaminda	惡意的，惡毒的
malamo	仇恨，憎恨，怨恨
malantaŭ	後，以後，之後，後面
malantaŭe	在後面，往後
malantaŭplano	背景
malaperi	不見，不見了
malaperis	不見了
malavara	慷慨
malbela	醜陋，醜
malbona	壞，孬
malbona humoro	孬脾氣
malbona kutimo	壞習慣
malbonega	邪惡
malbono	邪惡
malbonŝanco	孬運
malbonulo	壞人
malbonvola	勉強
maldika	薄，細
maldika intesto	小腸
maldorma	醒，清醒
maldormi	醒著
maldungi	炒魷魚，解雇
maldungita	失業
male	反而
malebligi	阻止，妨礙
malebria	清醒，醒
malebriiĝi	醒
malekvilibro	失衡
maleolo	踝，腳脖子，腳踝
malespera	絕望
malfacila	困難，難
malfeliĉa	傷心
malfeliĉego	災難
malfermi	張開，開，打開
malfermi la pordon	開門
malfluido	固體
malfluso	退潮
malforta	弱，軟弱
malfrua	晚，遲
malfruiĝi	來晚，遲到
malfruigi	誤，耽擱
malfruiĝis	來晚了
malgaja	傷心，難過
malĝentila	不客氣
malglata	粗糙
malĝoja	傷心
malgranda	小
malgranda fingro	小指
malgranda grupo	小組
malgrasa	瘦
malgraŭ	儘管，即使
malgraŭ tio	儘管如此，無論如何，不管怎樣
malĝusta	不對，錯
malhavi	缺少
malhelpi	幫倒忙
malica	邪惡
malico	邪惡
maljuna	老
maljusta	不公平
malklara	模糊
malkovri	發現
mallaborema	懶惰
mallarĝa	狹窄，窄
mallerta	笨拙
malleviĝi	下降
malliberejo	牢獄，監獄，獄，牢，監牢
mallonga	短
mallongigo	縮寫
malluma	黑暗
malluma materio	暗物質
malmodesta	傲慢
malmola	硬
malmulta	少
malmultekosta	便宜
malneto	草稿
malnova	老舊，舊
malofta	不頻發的，不常見的，稀少的，罕見的
malofte	很少有，不經常
malokupata	有空
maloportuna	不方便
malpacienca	不耐煩
malpermanenta	暫時
malpermesi	禁止
malpeza	輕
malpeza akvo	輕水
malpeza industrio	輕工業
malplena	空
malpli	少一點
malpliigi	減少
malpreciza	模糊
malprofunda	淺
malproksima	遠
malpura	骯髒
malpurigo	污染
malrapida	遲，慢
malrapide	慢慢
malrapidtrajno	慢車
malrapidvagonaro	慢車
malreala	假
malrekta	間接
malriĉa	貧窮
malŝalti lampon	關燈，關電燈
malsama	不同，不一樣
malsamo	差別
malsana	病
malsaniĝi	生病
malsano	疾，疾病，病
malsanulejo	醫院
malsanulo	病人
malŝarĝi	卸載，卸下
malsata	肚子餓
malsatega	饑餓
malsatego	饑荒
malscio	無知
malseka	濕
malseketaĵo	水分
malsimpla	複雜
malŝlosi	開鎖，開啟
malŝminki	卸妝
malsovaĝa	溫馴
malŝpari	浪費
malŝpari la tempon	浪費時間
malŝpari tempon	浪費時間
malŝparita	白費的，浪費的
malŝparo	浪費
malstreĉi	放寬
malstreĉiĝa	輕鬆，鬆
malstreĉiĝi	放輕鬆，放鬆
malstreĉita	鬆，輕鬆
malstrikta	鬆
malsukcesi	失敗
malsupre	下面，樓下
malsuprensalti	跳下
maltrafi	錯過
maltrankvila	緊張，擔心
malvarma	冷，寒冷
malvarmega	寒冷
malvarmumo	感冒
malvenko	挫敗，失敗，敗北
mambesto	哺乳動物，哺乳動物
mamo	乳，奶，乳房
mandarena	國語，官話，華語，北京話，普通話
mandiblo	頜骨，下頜，下顎，頜，顎骨，顎
mandragoro	曼陀羅草
manĝaĵo	食物
mangano	錳
mangarbo	芒果樹
manĝfingro	食指
manĝi	吃
manĝo	飯
manĝokarto	菜單
mangrovo	紅樹林，紅樹
maniero	方式，方法
maniso	穿山甲
mankateno	手銬，銬
manki	欠缺，缺少
manksako	手提袋
manlaboro	勞動
manlibro	手冊
mano	手
manplato	掌，手掌
manpremi	握手
manpremo	握手
mansaketo	手提袋
manto	螳螂，螳
mantuko	毛巾，手巾
maorio	毛利人
mar erinaco	海膽
mar-lutro	海獺
mararmeo	海軍
marbordo	海邊，海岸
mardo	星期二，禮拜二，二，周二
marfundo	海底
marioneto	木偶
maristo	水手
marleono	海獅
maro	海洋
marondo	海浪
Marso	火星，瑪爾斯
Marso I	火衛一
marstelo	海星
martelo	鐵錘
martestudo	海龜
marto	三月
masaĝi	按摩
maŝino	機器
maso	質量
masonisto	石匠
mastro	主人，主
matematiko	數學
matenmanĝi	吃早餐
matenmanĝo	早餐，噪音
mateno	早上，上午
materio	物質
matraco	床墊
matura	成熟，熟
meblaro	傢具
mebloj	傢具
meduzo	水母
mefito	臭鼬鼠
Mekao	麥加
meleagro	火雞
melo	狗獾，貛
melodio	旋律，調子
membro	肢
membro de la korpo	肢
membroj	四肢
membroj de la korpo	四肢
memfida	有信心，有自信
memoraĵo	紀念品
memori	記住，記得，記
memorigi	提醒，紀念
memoro	記憶
mencii	提到，提
mendelevio	鍆
menso	心，頭腦，思想
mensogi	撒謊，說大話，騙人，說謊
mensogi al	騙
mensogisto	騙子
mensogo	大話，謊言，謊，謊話
mensogulo	騙子
mentono	下巴
menuo	菜單
merkato	市場，市
merkredo	禮拜三，三，星期三，周三
Merkuro	默丘利，水星
mesaĝo	訊息
metaforo	比喻，隱喻
metalo	金屬
meteorito	隕石
meteoro	流星
meteoroido	流星體
meteorpluvo	流星雨
meti	放
metodo	方法
metroo	地下鐵
mevo	海鷗
meza	中
mezaĝa	中年
mezaĝa viro	中年男子
mezfingro	中指
meznombra	平均
meztagmanĝi	吃午飯
meztagmanĝo	午飯
mi	我
mi bedaŭras	不好意思，抱歉
mi mem	我自己
mi tre bedaŭras	真不好意思，很抱歉
mia	我的…
mia propra	我自己的
mielmonato	蜜月
mieno	表情
migdalkukaĵo	杏仁餅，杏仁酥
migdalo	杏仁
migdalokula	有杏仁眼
migri	移民
mikroskopo	顯微鏡
mil	千，一千
miliardo	一十億，十億
miliono	一百萬，百萬
militĉaro	車
militistaro	陸軍
militkrimulo	戰犯
militmalliberulo	戰俘
milito	戰爭，戰
miloble	千倍
milono	千分之一
mimozfloro	含羞草
mimozo	含羞草
min	我
minaci	威脅
minaco	恐嚇
Minerva	密涅瓦
Ming-dinastio	明朝
ministro	相
mino	地雷
Minotaŭro	米諾陶
minuto	分鐘，分
miraklo	奇跡
miriga	令人吃驚
mirinda	精彩
miskompreni	誤解
miskompreno	誤會
mistera	神秘
misuzi	濫用
mitaro	神話
mito	神話
mitokondrio	線粒體，粒線體
mitologio	神話
modelo	模式
moderna	現代
modesta	謙虛
modo	語氣
moki	嘲笑，笑
mola	軟
mola histo	軟組織
molaro	臼齒
molekula maso	分子量
molekulo	分子
molibdeno	鉬
momente	一回兒
momento	時刻
monato	月
monbileto	鈔票
monbiletujo	皮夾
Monda Banko	世界銀行，國際復興開發銀行
Monda Organizaĵo pri Sano	世衛組織，世界衛生組織，世衛
mondfama	聞名世界
mondo	世界，世
monereta mono	零錢
monero	硬幣
monkesto	保險箱
monludi	賭博
mono	金錢
monoftongo	單母音
monstro	怪物
monteto	山丘，小山
monto	山
montra fingro	食指
montra pronomo	指示代詞，指示詞
montri	給…看
montrofenestro	櫥窗
monujo	錢包
moralo	道德
morfemo	基本詞彙
morfologio	詞法，形態，構詞學
morgaŭ	明，明天
morti	去世
mortigi	殺死，殺
morto	死亡
mortpuno	死刑
morusarbo	桑樹，桑
moskeo	清真寺
moskito	蚊，蚊子
motivo	動機
motorciklo	機車
movi	移動，活動
movlibero	活動的餘地，活動的空間
movo	行動
mueldento	臼齒
muko	黏液
mulo	騾，騾子
multa	多
multaj	多
multĉelula	多細胞
multĉelula organismo	多細胞生物
multekosta	貴
multfoje	多次
multsignifa	很有意思
multspeca	多種
mumio	木乃伊
Munkena Interkonsento	慕尼黑協定
Munkena Konferenco	慕尼黑會議
murdi	謀殺
murdinto	凶手
muro	牆壁
murpapero	壁紙
muŝkaptilo de Venuso	捕蠅草
muskatarbo	肉豆蔻樹
muskoj	苔類，苔，青苔，苔衣，苔蘚
muskola histo	肌組織
muskola sistemo	肌肉系統
muskolo	肌，肌肉
muso	老鼠，滑鼠器，鼠
muŝo	蒼蠅，蠅
mustelo	黃鼠狼
muzeo	博物館
muzikgrupo	樂隊
muzikilo	樂器
muzikistaro	音樂團體
muzikisto	音樂家
muziko	樂，音樂
Muzoj	繆斯，詩歌女神繆斯姐妹
nacia himno	國歌
nacilingvo	民族語，母語
Nagario	天城文
naĝbaseno	游泳池
naĝi	游泳
naĝilo de ŝarko	魚翅，翅
naiva	天真
najbara	隔壁
najbaro	鄰居
najtingalo	夜鶯
nana stelo	矮星
Nanĉango	南昌
Nankingo	南京
Nanningo	南寧
narcisfloro	水仙花
narciso	水仙花
Narciso	那西塞斯
naski	生，生下
naskiĝdato	出生日期
naskiĝfesto	生日宴會
naskiĝi	生，出生
naskiĝis	生於
naskiĝtago	生日
naskokanalo	產道
natrio	鈉
natura	天然
naturdotita	有才能
naturo	自然
naŭ	九
naŭ mil	九千
naŭ miliardo	九十億
naŭ miliono	九百萬
naŭa	第九
naŭcent	九百
naŭcent mil	九十萬
naŭcent miliono	九億
naŭdek	九十
naŭdek du	九十二
naŭdek kvar	九十四
naŭdek kvin	九十五
naŭdek mil	九萬
naŭdek miliono	九千萬
naŭdek naŭ	九十九
naŭdek ok	九十八
naŭdek sep	九十七
naŭdek ses	九十六
naŭdek tri	九十三
naŭdek unu	九十一
naŭdeka	第九十
naŭfoje	九次
naŭoble	九倍
naŭono	九分之一
naŭza	噁心，惡
naza	鼻的，鼻音的
naza sinuso	鼻竇
nazia Germanio	納粹德國
nazkataro	感冒
nazmuko	鼻涕
nazo	鼻，鼻子
nazradiko	鼻梁
naztruo	鼻孔
naztuko	手帕
ne	非，不了，不
ne dankinde	不謝，不用謝謝，不客氣，不用謝
ne devus	不應該
ne dificila	不難
ne ekzisti	沒有
ne estas permesita	嚴禁
ne esti	不是，沒有
ne ĝenu min	別煩我
ne gravas	不要緊，沒關係
ne havi	沒有
ne malbona	不錯
ne malbone	還好，不錯
ne malfacila	不難
ne morala	不道德
ne nepre	未必，不一定，不見得，也不一定
ne nur	不只，不止，不但
ne nur... sed eĉ...	不但…還…
ne plu	不再
ne virta	不道德
ne voli	不要
ne ~u	別～，不要
Ne-Registara Organizaĵo	非政府組織
nea	消極
nea vorto	否定詞
neatendita	想不到
nebulo	霧氣
nebulozo	星雲
neceseja papero	衛生紙
neceseja seĝo	馬桶
necesejo	廁所
necesseĝo	馬桶
necesujo	馬桶
nedankinde	不謝，不用謝謝，不用謝，不客氣
nedaŭra	暫時
nedeklinaciebla	詞尾不變
nedeklinaciebla vorto	詞尾不變詞
nedifinita artikolo	不定詞
neebla	不可能
neelparolata litero	不發音字母
neforgesebla	難忘
negativo	否定詞
neĝbulo	雪球
neĝero	雪片，雪花
neĝhomo	雪人
neĝi	下雪
neĝo	雪
negocisto	商人
negoco	生意
nei	否認
nek	也不
nekredebla	不可思議
neleĝa	不合法，非法
nelonge	一回兒
nenia problemo	沒問題
neniam	從沒
neniu	誰都不，沒有人，無人，沒人，誰不
nenormala	不正常
neodimo	釹
neono	氖
neordinara	非常
nepra	絕對
nepre	必，一定，一定
nepre ne	一定不，決不
neptunio	鎿
Neptuno	涅普頓，海王星
Neptuno I	海衛一
nerekta objekto	間接賓語
nerekta parolo	間接引語
nerva sistemo	神經系統
nervo	神經
neseksa	無性
netransitiva verbo	不及物動詞
netuŝuminfloro	鳳仙花
netuŝumino	鳳仙花
neŭtra	中性
neŭtra genro	中性
neŭtra substantivo	中性名詞
neŭtra vorto	中性詞
neŭtrono	中子
neŭtronstelo	中子星
nevenkebla	無敵
ni	我們
ni ~u	不如
nia	我們的…
nia mem	我們自己
nia propra	我們自己的
nigra	黑色，黑
nigra humuro	黑色幽默
nigra tabulo	黑板
nigra truo	黑洞
nikelo	鎳
nikotiano	煙草
nin	我們
Ningŝjao	寧，寧夏
niobo	鈮
nitrogeno	氮
nivelo	程度
nobelio	鍩
nocio	概念
nokto	夜晚，夜
noktomezo	午夜
nombro	數字，數
nomi	叫
nomiĝi	叫做，叫
nominativa kazo	主格
nominativo	主格
nomo	名，名字
nomo de Ĝingis-Ĥano	鐵木真
nomumi	提名
Nord-Atlantika Traktat-Organizaĵo	北約，北約組織，北大西洋公約組織
norda cervo	馴鹿
Norda kaj Suda Dinastioj	南北朝
Norda Song-dinastio	北宋
nordo	北方
norma	普通，標準
normala	正常
normĉina	普通話，國語
noti	做筆記
notlibro	筆記本
noto	筆記，備忘錄，成績
nova	新
novaĵoj	新聞
novao	新星
novembro	十一月
nuba	多雲
nubo	雲
nuklea centralo	核能發電廠，核電廠，核電站
nuklea fendiĝo	核分裂
nuklea kunfandiĝo	核融合，核聚變
nuklea reakcio	核反應
nul	零，〇
nuligi	取消
numero	號碼，號
nun	現在
nur	只，而已
Nurenberga proceso	紐倫堡審判
nutra	營養
oazo	綠洲
objektiva	客觀
objekto	賓語
oblo	倍
observi	觀察
obstina	固執，頑固
Odiseo	奧德修斯
ofendi	侮辱，冒犯
ofendiĝi	感到冒犯
oferi	犧牲，牲，犧
oficejo	辦公室
oficiala	官，官方
oficista rango	官
oficisto	官
ofta	頻繁的，經常的
ofte	常，常常
ok	八
ok mil	八千
ok miliardo	八十億
ok miliono	八百萬
oka	第八
okazaĵo	機會，事件
okaze	偶然，碰巧
okazi	發生
okazigi	導致，引起，使發生
okazo	機會
okcent	八百
okcent mil	八十萬
okcent miliono	八億
okcidenta	西方的，西邊的，西部的
Okcidenta Ĝin-dinastio	西晉
okcidenta kulturo	西方文化
Okcidenta Ŝja-dinastio	西夏
okcidento	西方
okcipita lobo	枕葉
okdek	八十
okdek du	八十二
okdek kvar	八十四
okdek kvin	八十五
okdek mil	八萬
okdek miliono	八千萬
okdek naŭ	八十九
okdek ok	八十八
okdek sep	八十七
okdek ses	八十六
okdek tri	八十三
okdek unu	八十一
okdeka	第八十
okfoje	八次
okoble	八倍
okono	八分之一
okromarbo	西印度輕木
okromo	西印度輕木
oksigeno	氧
oktobro	十月
okulglobo	眼球
okulharo	睫，眼睫毛，睫毛
okulisto	眼科醫生
okulkavo	眼窩
okulo	眼，睛，目，眼睛
okulumi	凝視，盯著看
okulvitroj	眼鏡
okupata	沒空，忙碌，忙
ol	比
Olimpikoj	奧運會，奧運
olivarbo	欖，橄，橄欖樹
omaro	龍蝦
ombrelo	雨傘
ombro	影，影子
ondego	巨浪
ondo	浪，波浪
onidiro	謠言
onomastiko	姓名學
onomatopeo	象聲詞
OPEL	油組
operacio	手術
operaciumo	操作系統
opero	歌劇
opinio	意見，看法
oportuna	方便
optika iluzio	光幻覺，光學幻覺，錯視
optika nervo	視神經
optiko	光學
optimisma	樂觀
ora	金
oranĝa	橘色
oranĝa stelo	橙星
oranĝarbo	橙，橙樹
oranĝkolora	橘色
orbito	眼窩
orcino	虎鯨
orda	整潔
ordigi	整理
ordinara	平常，普通
ordoni	命令
ordono	命令
orela lobo	耳垂
orelkonko	耳廓，外耳
orellobo	耳垂
orelo	耳，耳朵
orelringo	耳環
orelvakso	耳垢
oretamburo	鼓膜
orfejo	孤兒院
Orfeo	俄爾甫斯
orfo	孤兒
organeto	細胞器
organika	有機
organismo	生物
organizaĵo	機構，組織
Organizaĵo de Petrol-Eksportaj Landoj	油組，石油輸出國組織
Organizaĵo de UN por Edukado, Scienco kaj Kulturo	聯合國教育科學文化組織
Organizaĵo por Ekonomia Kunlaboro kaj Evoluo	經濟合作發展組織，經合發組織
Organizo de la Islama Konferenco	伊斯蘭會議組織
organo	器官
Orienta Ĝin kaj la Deksesa-Reĝlandoj	東晉十六國
Orienta Ĝin-dinastio	東晉
orienta kulturo	東方文化
orientamerika larikarbo	美洲落葉松樹，美洲落葉松
orientamerika lariko	美洲落葉松樹，美洲落葉松
oriento	東方
oriento kaj nordo	東西
originala	獨到
origine	本來
orkido	蘭，蘭花
orko	虎鯨
orkolora	金，金色
ornitorinko	鴨嘴獸
oro	金
Orostelo	金星
orpluvfloro	金鏈花
orpluvo	金鏈花
ortodoksismo	希臘正教
orvergo	秋麒麟草
oscedi	打哈欠
oscedo	哈欠
osmantarbo	桂花樹
osmanto	桂花樹
osmantofloro	桂花，桂
osmio	鋨
osta histo	骨組織
osta medolo	骨髓，髓
ostaro	骷，髏，骨骼，骨架，骷髏
osto	骨頭，骨
ostohisto	骨組織
ostro	牡蠣，蠣
ovodukto	輸卵管
ovujo	卵巢
pacienca	有耐心
pacienco	耐心
packontrakto	和約
paco	和平，安
pafilego	炮
pagi	付錢，付給
paĝo	頁
pajlo	稻草
pakaĵo	行李
paketo	包裹
pakvagono	行李車
paladio	鈀
palindromo	迴文
Palio	巴利語
palisandro	薔薇樹，花梨樹，花梨木樹，花梨木，黃檀樹，薔薇木，黃檀木
palmo	棕，棕櫚，棕櫚樹，櫚
palpebro	眼皮
palpi	摸，抓，觸摸
palto	外套，大衣
pampelmusarbo	柚，柚樹，柚子樹
panarbo	木波羅樹，麵包果樹，麵包樹，木波羅
pando	熊貓，貓熊
Pandora	潘多拉
panero	麵包屑
paniko	恐慌
panisto	麵包師傅
pankreaso	胰，胰臟
pano	麵包
panrostilo	烤麵包機
pansaĵo	繃帶
pantalono	褲子
pantoflo	拖鞋
papago	鵡，鸚，鸚鵡
papajarbo	木瓜樹
papavetfloro	虞美人花，虞美人
papaveto	虞美人，虞美人花
papavfloro	罌粟花
papavo	罌粟花
paperkorbo	廢紙簍
papero	紙，紙張
papilio	蝶，蝴蝶，蝴
paragrafo	段，段落
paralela	平行
paraŝuto	降落傘
parazito	寄生物
pardoni	原諒
pardonon	對不起
pardonu min	很抱歉
parenca	親
parencaro	親戚
parenco	親屬，親戚
parfumo	香水
parieta lobo	頂葉
Pariza Packonferenco	巴黎和會，巴黎和會
Pariza packontrakto	巴黎和約，巴黎和約
parkejo	停車場
parko	公園
parolado	演講
parolas esperanton	講世界語
paroli	說話，講話，會
paroli esperante	說世界語，講世界語
paroli esperanton	說世界語
parolilo	喇叭
parolo	語，言語，腔
participo	分詞
partieco	偏見
partiklo	粒子
partikulo	助詞
partio	政黨，黨，派對
Partio de Eŭropaj Socialdemokratoj	歐洲社會黨
parto	部分
parto de parolo	詞類
partopreni	參加
pasero	麻雀，雀
pasi	經過
pasinteco	過去
pasio	激情
pasiva	被動
pasiva participo	被動分詞
pasiva voĉo	被動語態
pasivo	被動語態
paŝo	步調，步，腳步
pasporto	護照
patelo	膝蓋骨
patriĉo kaj filiĉo	父子
patriĉo kaj filino	父女
patriĉofiliĉa	父子
patriĉofilina	父女
patrino kaj filiĉo	母子
patrino kaj filino	母女
patrino kaj filo	母子
patrinofila	母子
patrinofiliĉa	母子
patrinofilina	母女
patrio	故鄉
patriota	愛國
patriotismo	愛國主義
patro kaj filino	父女
patro kaj filo	父子
patrofila	父子
patrofilina	父女
patroli	巡邏
paŭzi	休息
peco da papero	一張紙
pediko	虱
Pegazo	飛馬
pego	啄木鳥
pejzaĝo	風景，景
Pekino	北京，京
pektoralo	胸大肌
pelargonifloro	天竺葵
pelargonio	天竺葵
pelikano	鵜，鶘，鵜鶘
pelvo	骨盆
penado	努力
pendumo	絞刑
peni	力圖，試圖，爭取
peno	努力，力氣
pensadi	思考
pensado	思想
pensi	覺得，想
pensi ke	認為
pensio	退休金，養老金
pensmaniero	想法
penso	念頭
penti	懺悔
pentraĵo	畫
pentri	畫畫
pentri pentraĵon	畫畫
pentristo	畫家
peonifloro	牡丹，牡丹花
peonio	牡丹花，牡丹
peono	兵
per	用
pera	間接
peranto	經紀人
perdi	失，失去
perdiĝi	迷路
perfekta	完美
perfidi	背叛
perforta	暴力
perforto	暴力
perikardo	心包
Periodo de la Deksesa-Reĝlandoj	十六國
Periodo de la Orienta Ĝin kaj la Deksesa-Reĝlandoj	東晉十六國
Periodo de la Tri Reĝlandoj	三國時代，三國
permesilo	執照
persekutado	迫害
persekuti	迫害
Perseo	珀耳修斯，珀修斯
persikarbo	桃，桃樹
persikfloro	桃花
persona	個人
persona pronomo	人稱代詞
personeco	個性
persono	人
pesilo	磅秤
pesimisma	悲觀
petalo	瓣，花瓣
petola	淘氣，胡鬧
petolaĵo	惡作劇
petolema	調皮的，愛胡鬧的
petoli	胡鬧，搗蛋
petunifloro	矮牽牛花
petunio	矮牽牛花
peza	重
peza industrio	重工業
pezo	重量，體重
piano	鋼琴
picearbo	雲杉樹，雲杉
picejo	匹薩店，披薩店，比薩店
piceo	雲杉，雲杉樹
pico	披薩，匹薩，比薩，比薩餅，披薩餅，匹薩餅
piedfingro	腳趾頭，趾
piediranto	行人
piedo	足，腳
piedspuro	腳印，足跡
pika	辣的，有刺的，有倒鉤的
pika gusto	辣味
pikdrato	鐵絲網
pikilo	刺，倒鉤
pikniko	野餐
pilgrimado al Mekao	麥加朝聖
Pilgrimo al la Okcidento	西游記
pilo	電池
pinarbo	松，松樹
pinglo	別針
pingveno	企鵝
pino	松，松樹
piramido	金字塔
pirarbo	梨，梨樹
pirato	海盜
pistilo	雌蕊
pistilo de floro	雌蕊
pituitaria glando	腦垂腺
pivotradiko	直根，主根
pizo	豌豆
placento	胎盤
plaĉi	取悅
plaĉi al	喜歡
placo	廣場
plafono	天花板
plaĝo	沙灘
plando	腳底
planedo	行星，星球，惑星
planko	地板
plano	計劃
plantejo	農園
planto	植物
plasto	塑膠
platanarbo	懸鈴木樹，梧，梧桐，懸鈴木，桐，梧桐樹
platano	懸鈴木樹，梧桐樹，懸鈴木，桐，梧，梧桐
plateno	鉑
platikodonfloro	僧帽花，鈴鐺花，桔梗
platikodono	桔梗花，桔梗，鈴鐺花，僧帽花
pledi	辨護
plej	最
plejparto	大多數，大部分
plena	滿
plena da	充滿了
plendi	抱怨
plendo	牢騷，怨言
plenkreska	成人
plenkreskulo	成人，大人
plenluno	滿月
plezura	愉快
pli	比較，較，更
pli kaj pli	越來越
pli kaj pli bone	越來越好
pli malfrue	晚一點
pli malpli	差不多
pli multa	多一點
plia	額外
plialtigi	增加
plibonigi	改善
pliboniĝi	改進，變得更好
pliboniĝo	進步
plifortigi	增強
plimulta	更多
plimultigi	增加
pliposte	晚一點
plori	哭，流眼淚，哭泣，流淚
plorsalikarbo	垂柳，垂柳樹
plorsaliko	垂柳，垂柳樹
plu	多一點
plumbo	鉛
plumo	羽毛，筆，羽
pluraj	多
plurala finaĵo	複數詞尾
plurala pronomo	複數代名詞，複數代詞
pluralo	複數
plurjara	多年生
plurjara herbo	多年生草本
plutonio	鈽，鈈
Plutono	冥王星，普魯托
pluvero	雨滴
pluvi	下雨
pluvmantelo	雨衣
pluvo	雨
poema	詩意
poemaro	詩集
poemo	詩歌
poeto	詩人
poezia	詩意
pojno	手腕，腕
polekso	大拇指
polemiko	爭議
poleno	花粉
policano	警察，警察人員
policejo	警察局
policisto	警察，警察人員
polico	警察，警
politiko	政治，政策
polonio	釙
polpo	章魚
polusa urso	北極熊
polvo	塵土，灰
polvoŝovelilo	畚箕
polvosuĉilo	吸塵器
pomarbo	蘋，蘋果樹
poplarbo	白楊樹，白楊
poplo	白楊樹，白楊
popolkanto	民謠，民歌
popolo	人民，民
populara	流行，紅
por	為了
pordego	門
Pordego de Ĉiela Paco	天安門廣場
pordo	門戶，門口，戶，門
porko	豚，豕，豬
poro	毛孔
poŝdiskilo	隨身聽
poseda kazo	所有格
poseda pronomo	所有格代名詞
posedaĵo	財產
posedi	擁有
posedo	所有格
poŝkasedilo	隨身聽
poŝlanterno	手電筒
poŝo	口袋
post	後，以後
poŝtaĵo	郵件
postbrako	膀
postdrinka kapdoloro	宿醉
poste	以後，然後
postebrio	宿醉
poŝtejo	郵局
poŝtisto	郵差
poŝtkarto	明信片
postkuri	追趕
poŝtmarko	郵票
poŝto	郵
poŝtoficejo	郵局
postparto de kolo	項
postpozicio	後置詞
postsigno	線索
postsono	回聲
posttagmezo	下午
poŝtuko	手帕
postuli	要求
postulo	要求
postvango	屁股
potencebla	潛在
potenciala	潛在
Potsdama Konferenco	波茨坦會議
povi	能，會，可以
poviga	潛在
Pozidono	波塞冬
pozitiva	積極
praavoj	祖先
praĉelo	乾細胞
Praeksplodo	大爆炸
praktika	實際
prapatroj	祖先
prava	真實
pravi	說得對
prazeodimo	鐠
precipe	尤其
predikato	述語，謂語，動詞謂語
prefikso	字首，首碼
preĝi	禱告，禮拜
preĝo	祈禱
premi butonon	按電鈕，按鈕
premiiĝi	中獎
premo	壓力，壓強
premolaro	前臼齒
premsonĝo	噩夢，夢魘，惡夢，魘
preni	拿
preni la tutan respondecon	負全部責任
prepozicio	前置詞，介詞
presilo	印表機
preskaŭ	差點，幾乎
preskaŭ nenio	幾乎沒有
preskaŭ neniu	幾乎沒有
preta	準備好了
preteksto	藉口
preterita participo	過去分詞
preterita tempo	過去式
pretiĝi	準備
pretigi	準備
pretpansaĵo	繃帶
preventi	阻止
prezenca tempo	現在時
prezenti	介紹
prezidanto	總統
prezkonjekto	預算
prezo	價格
pri	關於
primoki	嘲笑
primolfloro	報春花，櫻草花
primolo	櫻草花，報春花
princino	公主
princo	王子
printempo	春，春天
pripensi	考慮
priskribi	形容
privata	私人，私
privateco	隱私
priverŝi	澆水，澆
prizorgi	照顧
pro tio	所以
probablo	機會率，概率，機率，或然率
problemo	問題，麻煩
procedi	進行
procedo	手續
procezo	過程
prociono	浣熊
produkti	產生
produkto	產品
profesia	職業
profesio	行業
profesoro	教授
profetaĵo	預言
profeto	先知
profito	利潤
profunda	深
programaro	軟體
programo	節目
progresi	進步
progreso	進步
prokarioto	原核生物
proksima	近
proksimaĵo	附近
proksimulo	鄰居
proksimume	左右
promeni	散步
promesi	答應
promeso	承諾
Prometeo	普羅米修斯
prometio	鉕
pronomo	代詞，代名詞
prononcmaniero	口音
prononco	發音
proponi	建議
propono	建議，提議
propozicio	從句，子句
propra	私人，私，自己的
propra nomo	專有名詞
propraĵo	財產
propraokule	親眼
propraokule vidi	親眼看到
prospera	繁榮
prostato	攝護腺，前列腺
protaktinio	鏷
proteino	蛋白質
protekti	保護
protestantismo	新教
protesti	抗議
proton	質子
provi	試，試圖，嘗試
provinco	省，省份
provizejo	倉庫
provizi	提供
provizora	暫時
provizore	臨時
provizumi	供應
provtubo	試管
prunarbo	李樹，李
prunelarbo	黑刺李樹，黑刺李
pruntedoni al	借給
pruntepreni libron	借書
pruntepreni monon	借錢
prunti al	借給
prunti libron	借書
prunti monon	借錢
prunto	貸款
pruvi	證明
pruvo	證據
psikologo	心理學家
publika	公用，公
publika telefono	公用電話
pugno	拳頭，拳
pugo	屁股
pulma arterio	橈動脈，肺動脈
pulmo	肺臟，肺
pulo	蚤，跳蚤
pulsaro	脈衝星
pulso	脈搏
pulsostelo	脈衝星
pulvoro	粉末
pumo	美洲獅
puni	處罰
puno	懲罰
pupilo	瞳，瞳孔
pupo	傀儡
pura	乾凈
pura alkoholo	酒精
purigi	清潔
purpura	紫色，紫
puŝi	推
puŝo	推
puso	膿
puŝveturilo	手推車，獨輪推車
puto	井
racieco	理性
racio	道理
radaro	雷達
radikalulo	激進分子
radiko	樹根，根，詞根
radio	收音機
radiumo	鐳
radiuso	橈骨
radono	氡
rajdi sur ĉevalo	騎馬
rajti	可，可以
rajto	權利
raketo	火箭
rakonti	告訴
rakontintrigo	劇情
rakonto	故事
Ramadano	齋戒月
ranido	蝌蚪，蝌，蚪
rano	蛙，青蛙
rapida	快
rapideco	速度
rapidi	趕
rapidi al	趕往，趕到
rapidvagonaro	快車
raporti	報導
raporto	報告
raŭpo	毛毛蟲
re	再
reago	反映
reala	真，真正
realaĵo	現實
rebonigi	修理
red dwarf	紅矮星
redaktisto	編輯
redaktoro	編輯
redoni	還給
refleksiva pronomo	反身代詞
regi	控制
reĝino	女王
regiono	區
reĝisoro	導演
registaro	政府
reĝlando	王國
reĝo	王，國王，王
regulo	規則
reĝustigi	調整
reiri	回去
reiri hejmen	回家
reklamo	廣告
rekomendi	推薦，薦
rekompenco	報酬
rekoni	辨認
rekordo	紀錄
rekta	直接
rekta objekto	直接賓語
rekta parolo	直接引語
rektangulo	長方形
religio	宗教，教
rendevuo	約會
renio	錸
renkonti	見面，見，遇到，見面
renkontiĝi	見面
reno	腎臟，腎
repagi	償還，還錢
reprezenti	代表
reprodukta organo	生殖器官，生殖器
reprodukta sistemo	生殖系統
reptilio	爬蟲類
resanigi	醫
resono	回聲
respekti	尊重
respekto	尊敬
respondaparato	答錄機
respondeca	負責
respondeci pri	負責，負責任，為…負責
respondeco	責任
respondeculo	負責人
respondi	回答
respondo	答案
restanta dento	恆齒
resti	留，留在，保持
restmono	零錢
restoracio	餐廳
retino	視網膜
reto	網路，網，絡
retotaglibro	部落格，博客
retpaĝaro	網頁
retpoŝt-adreso	伊妹兒地址，電子郵件地址，電郵地址
retpoŝto	電子郵件，電郵，伊妹兒
reveni	回來
revi	作白日夢
revidi	再見
revo	白日夢
revolucio	革命
revuo	雜誌
rezino	樹脂
rezisti	抵抗
rezona	合理
rezulto	結果
ribonukleata acido	核糖核酸
ribosomo	核糖體
riĉa	有錢
riĉeco	財富
ricevatesto	收據
ricevi	收到
ridado	笑聲
rideti	微笑
rideto	笑容
ridi	樂，笑
ridiga	好笑
ridinda	可笑
ridmieno	笑臉
rifuĝinto	難民
rifuzi	拒絕
rigardi	看
rilato	關係
rimarki	注意
rimarkinda	值得注意，異常，非凡
rimedo	資源
ringa fingro	無名指
ringo	戒指
rinocero	犀，犀牛
ripari	修理
ripkaĝo	肋骨架
ripo	肋骨，肋
ripozi	休息
risorto	彈簧
rivero	河，江，河流，川
rizo	大米飯，飯，米，米飯，大米，稻米
rizokampo	稻田
rizomo	根狀莖，根莖
rizvino	清酒
RNA	核糖核酸
robinio	洋槐樹，刺槐，刺槐樹
roboto	機器人
rodio	銠
roko	岩石
rolo	角色
romano	小說
romantika	浪漫
romia mitaro	羅馬神話
romia mitologio	羅馬神話
rompi	打破，弄壞，打碎，破壞
rompiĝema	易碎，脆弱
rompita	壞了，弄壞的，破碎的
rompŝtelisto	竊賊
rondo	圓形
ronĝulo	齧齒類
rosmaro	海象
rozfloro	玫瑰，玫瑰花，月季花，薔薇，薔，玫，薔薇花，瑰
rozkolora	粉紅色，粉，粉紅
rozo	薔，玫，玫瑰，薔薇花，薔薇，瑰，月季花，玫瑰花
rubando	絲帶
rubidio	銣
ruboj	垃圾
rubujo	垃圾桶
rudbekifloro vila	黑心菊，黑心菊花，金光菊，金光菊花
rudbekio vila	金光菊，金光菊花，黑心菊花，黑心菊
ruĝa	紅色，紅
ruĝa giganto	紅巨星
Ruĝa Krescento	紅新月會
Ruĝa Kruco	紅十字會
ruĝa ligno	紅杉樹，紅杉
ruĝa sanga korpusklo	紅血球，紅細胞
ruĝa stelo	紅星
ruĝgorĝulo	知更鳥
ruĝiĝi	臉紅
ruĝligno	紅杉，紅杉樹
ruinigi	破壞
rulseĝo	輪椅
rusti	生鏽
rusto	銹，鐵鏽
rutenio	釕
ruza	狡猾
ruzaĵo	詭計
ruzo	詭計
sabato	星期六，周六，六，禮拜六
sablero	沙粒
sablo	沙子
ŝablono	模式
sadisto	虐待狂
ŝafaĵo	羊肉
ŝafido	小羊
ŝafino	母羊
ŝafo	羊
saĝeco	智慧
saĝo	智慧
sago	矢，箭
saĝodento	智齒
ŝajne	顯然
ŝajni	好像
ŝajni ke	好像
ŝakludi	對弈，弈，下棋
ŝakludo	棋，西洋棋
sako	袋子
ŝako	西洋棋，棋
ŝakpeco	棋，棋子
ŝaktabulo	棋盤
sala	鹹的
sala akvo	鹹水
sala gusto	鹹味
salajro	薪水
sali	撒鹽，加鹽
salikarbo	楊柳，柳樹，楊柳樹，柳
saliko	柳，楊柳樹，柳樹，楊柳
salikoko	蝦子，蝦
salivi	垂涎
salivo	口水，唾液
salivtuketo	圍嘴
salivumi	流口水
salmo	鮭魚，鮭
salo	鹽，鹽巴
salsolo	風滾草
ŝalti lampon	開燈，開電燈，打開電燈
ŝaltilo	開關
saluto	招呼
saluton	嗨，你好
sama	同，一樣
samario	釤
sambukarbo	接骨木，接骨樹，接骨木樹
sambuko	接骨木，接骨木樹，接骨樹
samĉambrano	室友
same kiel antaŭe	依舊，依然，照樣，依，照舊
samlandano	同胞
samnoma	同音詞，同音字
ŝampuo	洗髮精
samseksema	同志
samsonoras kiel	聽起來像
samspeca	類似
samtempe	同時
sana	健康
Ŝandongo	山東，魯
Ŝang-dinastio	商朝
ŝanĝi	改變
sangi	流血
ŝanĝiĝi	變
ŝanĝiĝo	變化
ŝanĝo	變化
sango	血液
sangoĉelo	血細胞，血球
sangocirkula sistemo	迴圈系統
sangoverŝo	流血
Ŝanhajo	上海，山西，晉
sankta	神聖
Sankta Romia Imperio	神聖羅馬帝國
Sanktejo Jasukuni	靖國神社
sano	健康
Ŝanŝjio	滬
Sanskrito	梵文，梵語
sapo	肥皂
sardelo	沙丁魚
sarkasma	諷刺
ŝarko	鯊魚，鯊
satelito	衛星
ŝati	喜歡，欣賞
Saturno	土星
ŝaŭmo	泡沫
sceno	場面
sciencisto	科學家
scienco	科學
scii	知，知道
sciiĝi	得知
sciigi	通知
scio	知識
scipovi	會
sciuro	松鼠
scivola	好奇
se	如果
se vi ne zorgas	如果你不介意的話
sed	但，可，可是，但是
seĝo	椅子
ŝejko	酋長
seka	乾，乾的
sekala pano	黑麵包
sekalo	裸麥，黑麥
sekalpano	黑麵包
sekeco	乾燥
sekiga tuko	擦乾杯盤餐具等的抹布
sekigi	使變乾
sekiĝi	變乾
sekigita toŭfuo	豆乾
sekretariejo	秘書處
Sekretariejo de UN	聯合國秘書處
sekretario	秘書
sekreto	秘密
sekso	性，性別
seksvivo	性生活
sekundo	秒鐘，秒
sekura	安全
Sekureca Konsilio	安理會
sekureco	安全性
sekvaj	下列
sekvanta	下個
sekve	於是
sekve de tio	於是
sekvojarbo	紅杉樹，加州紅木，巨杉樹，世界爺樹，巨杉，水杉樹，世界爺，紅杉，水杉
sekvojo	加州紅木，世界爺，紅杉樹，世界爺樹，水杉樹，巨杉樹，巨杉，水杉，紅杉
seleno	硒
ŝelo	外殼，皮
selo	鞍，馬鞍
semajnfino	周末
semajno	星期
semikonduktaĵo	半導體
semo	籽，種子，子，核，種
sen	無
senĉesa	不斷
senĉese	不斷，不停
senco	意義
sendanĝera	安全
sendanĝereco	安全性
sendependa	獨立
sendi	寄給
senduba	無庸置疑
sendube	無疑
senĝena	不客氣
senhaŭtigi	剝皮
senhava	窮的，窮苦的，窮困的
senhaveco	窮苦，窮困
senhavigi	剝奪，使失去
senhavulo	貧民，窮人
senhelpa	無助，無依無靠
senhonta	無恥
senhonte	無恥地，不知羞恥地
Ŝenjango	沈陽
senkapigi	斬首
senkulpa	無辜
senlabora	失業
senlaboreco	失業
senmorta	長生不老
sennoma fingro	無名指
senpaga	免費
senpolvigi	除塵，去掉～的灰塵
senprobleme	順利
senŝeligi	剝皮，剝殼，去殼，削皮
senŝeligita	去殼的
senŝeligita rizo	糙米
sensenca	荒唐的，荒謬的
sensencaĵo	荒謬的事，荒唐的事
sensenceco	荒謬
sensignifa	無意義的
Ŝenŝjio	陝，陝西
sensperta	無經驗的，不熟練的
senspira	喘不過氣來的，氣喘吁吁的
sentaŭga	沒用，無用，不中用，毫無用處
sentaŭgulo	一無是處的人，沒出息的人，無用的人，飯桶，廢物
sentema	敏感
senti	覺得
sento	感覺
senutila	沒用，無用
senvestiĝi	脫衣服
sep	七
sep mil	七千
sep miliardo	七十億
sep miliono	七百萬
sepa	第七
sepcent	七百
sepcent mil	七十萬
sepcent miliono	七億
sepdek	七十
sepdek du	七十二
sepdek kvar	七十四
sepdek kvin	七十五
sepdek mil	七萬
sepdek miliono	七千萬
sepdek naŭ	七十九
sepdek ok	七十八
sepdek sep	七十七
sepdek ses	七十六
sepdek tri	七十三
sepdek unu	七十一
sepdeka	第七十
sepfoje	七次
sepoble	七倍
sepono	七分之一
septembro	九月
ŝercema	愛開玩笑
ŝerci	開玩笑
serĉi	追求，找
ŝerco	笑話
serialo	連續劇
serio	系列
serioza	嚴肅
serpento	蛇
servi	服務
servo	服務
servu vin	請便
ses	六
ses mil	六千
ses miliardo	六十億
ses miliono	六百萬
sesa	第六
sescent	六百
sescent mil	六十萬
sescent miliono	六億
sesdek	六十
sesdek du	六十二
sesdek kvar	六十四
sesdek kvin	六十五
sesdek mil	六萬
sesdek miliono	六千萬
sesdek naŭ	六十九
sesdek ok	六十八
sesdek sep	六十七
sesdek ses	六十六
sesdek tri	六十三
sesdek unu	六十一
sesdeka	第六十
sesfoje	六次
sesoble	六倍
sesono	六分之一
Seulo	漢城，首爾
severa	嚴，嚴格
severe	嚴
sezono	季節
sfagnoj	水蘇
Shijiazhuang	石家莊
ŝi	她
ŝia	她的
ŝia propra	她自己的
Siĉŭano	川，四川
sidejo	座位
sidi	坐
sidi ĉetable	入席
sidiĝi	坐下
sidloko	座位
sidvango	大臀肌，屁股
signalo	信號
signifi	代表，表示
signifo	意義，含義，意思
signo	符號，字
Signolingvo	手語
sikhismo	錫克教
sikomorarbo	美國梧桐樹，美國梧桐
sikomoro	美國梧桐，美國梧桐樹
silabo	音節
ŝildo	盾
silento	沉默
silicio	矽，硅
simboli	象徵
simbolo	象徵
simila	類似，似，很像，像
simileco	明喻
simio	猴，猴子
simpla	簡單
simple	簡直
ŝin	她
sin intermeti	干涉
sincera	誠懇
sincereco	誠意
singarda	小心
singardema	小心
sinĝena	害羞
sinĝenema	害羞
Ŝinĝjango	新疆，新
singulara finaĵo	單數詞尾
singulara pronomo	單數代詞，單數代名詞
singularo	單數
sinonimo	同義字，同義詞
sintakso	句法
sinteno	態度
sinuso	鼻竇
ŝipestro	船長
ŝirdento	裂齒
sireno	海牛，美人魚
siringfloro	紫丁香花，紫丁香
siringo	紫丁香花，紫丁香
ŝirmejo	避難所，庇護所
ŝirmi	保護，庇護
ŝirmilo	避難所，庇護所
ŝirmo	避難所，庇護所
ŝirmtegaĵo	防塵布，防塵罩，防護罩
sistemo	系統
sitelo	水桶
situacio	情況，場合
situi	位於
Ŝja-dinastio	夏朝
Ŝjiano	西安
Ŝjiningo	西寧
skandalo	醜聞
skandio	鈧
skapolo	肩胛骨
skarabo	甲蟲
skatolmalfermilo	開罐器
skatolo	盒子
skeleta sistemo	骨骼系統
skeleto	骷，髏，骷髏，骨架，骨骼
sklavo	奴，隸，奴隸
skorpio	蠍子，蠍
skribi	寫，寫字
skribmaŝino	打字機
skribo	文
skribotablo	寫字檯，書桌
skribtablo	書桌
skulptaĵo	彫刻品，雕像
sledo	雪橇
ŝlosi	鎖上
ŝlosila	關鍵
ŝlosilo	鑰匙
ŝlosita	鎖住的，鎖定的
ŝloso	鎖頭
smeraldo	翡翠
ŝminki	化妝
ŝminko	化妝品
ŝnuro	繩索
socia kontrakto	社會契約
socio	社會
sofo	沙發
soforarbo	槐樹，槐
soforo	槐樹，槐
soifa	口渴
sojfaba lakto	豆漿
sojfabo	大豆，黃豆
soldato	兵，軍人，卒
soleca	寂寞
solidago	秋麒麟草
solidigi	固化
solido	固體，固體
solvi	解決
somero	夏，夏天
sonaparato	音響
sonbendo	卡帶，錄音帶
Song-dinastio	宋朝
sonĝi	夢見，做夢，夢到
soni	聽起來
soni simile	聽起來很像
sono	聲音
sonorilo	鈴
sonserpento	響尾蛇
sopiri	渴望
sorbi	吸收
sorĉistino	巫婆
sorĉisto	巫師
sorparbo	歐洲花楸樹，歐洲花楸，花楸，花楸樹
sorto	命運，命
ŝoseo	高速公路
sovaĝa	蠻，野蠻
sovaĝa karoto	野胡蘿葡
sovaĝa pomarbo	西府海棠樹，海棠，西府海棠，海棠樹
ŝovelilo	鏟子
spaco	空間
spacotempo	時空
spadfiŝo	旗魚
ŝpari	省
ŝpari monon	省錢，存錢
speciala	特，特別
speciala administra regiono	特別行政區
Speciala Relativeco	狹義相對論
speco	種類，種
spegulo	鏡，鏡子
spekti filmon	看電影
sperti	經歷
sperto	經驗
spertulo	專家
spina medolo	脊椎骨，脊，脊骨，脊髓
spino	脊椎
spiono	間諜
spira sistemo	呼吸系統
spiri	呼吸
spirito	心靈，精神
spongo	海綿
sporto	體育
spuro	跡
ŝranko	櫥櫃
ŝraŭbi	擰螺絲，擰螺釘
ŝraŭbilo	扳手，活動扳手
ŝraŭbingo	螺母，螺帽
ŝraŭbo	螺絲，螺釘
ŝraŭbŝlosilo	扳手，活動扳手
ŝraŭbtenilo	老虎鉗
ŝraŭbturnilo	螺絲起子，螺絲刀
ŝtala	鋼製的，鋼鐵的
ŝtalo	鋼鐵
stameno	雄蕊
standardo	國旗
stano	錫，錫
ŝtataneco	國籍
ŝtatestro	國家元首
ŝtatigi	使國有化
ŝtatigo	國有化
ŝtato	國家
stato	狀態，狀態
stato de materio	相態，物態，相
statuo	雕像
stebkovraĵo	被子
ŝtele	偷偷地，偷偷摸摸地
ŝteli	偷，竊取
ŝteliri	偷走，偷去
ŝtelisto	小偷
ŝtelo	偷竊，盜竊
stelo	星，恆星，星星
ŝtelrigardi	偷看
stelulo	明星
sterko	肥料
sternumo	胸骨
ŝtipo	木塊
stomako	胃
ŝtonego	岩石
ŝtonhakisto	石匠
ŝtono	石頭
ŝtopilingo	插座
ŝtopilo	插頭
stranga	怪，奇怪，奇
strategio	策略
strato	街道
strigo	貓頭鷹
striko	罷工
strikta	緊
strio	長條，條紋
stroncio	鍶
strukturo	結構
ŝtrumpeto	襪子
struto	鴕鳥，鴕
studanto	學生
studento	生，大學生
studi	學習
studi	讀書，學習，複習，念書
ŝtuparo	臺階，階梯，樓梯，梯
ŝtupetaro	梯子，梯
ŝtupo	級，梯階，階
Ŝu-Reĝlando	蜀國
sub	以下，下，之下，下面
subbrako	腋，腋窩，胳肢窩
subĉemizo	汗衫
subhaŭta	皮下
subhaŭta histo	皮下組織
subita	忽然
subite	突然，忽然
subjektiva	主觀
subjekto	主語
subjunkcio	虛擬語氣
subskribi	簽，簽名
subskribi packontrakton	簽和約
substantiva vortfinaĵo	名詞詞尾
substantivo	體詞語，名詞
substreki	強調
subŝtupare	樓下
subtaso	茶托，碟子
subtegmentejo	閣樓
subtegmento	閣樓
subteni	支持
subteno	支持
subtera	地下
subtitolo	字幕
subtitolo de filmo	電影字幕
subvencio	補助金
Suda Song-dinastio	南宋
sudo	南方
Suej-dinastio	隋朝
suferanto	被害人
suferi	忍耐，忍受，受苦
suffiĉe	夠，足夠
sufiĉe	蠻，挺
sufiĉe bona	蠻好，挺好
sufiĉega	豐富
sufikso	後綴，字尾
sugesti	建議
sukcese	順利
sukcesi	成功
sukceso	成功
suko	樹液
ŝulaĉo	鞋帶
ŝuldi	欠缺
sulfuro	硫
sulka	皺皺的
ŝultro	肩，肩膀
sumakarbo	漆樹
sumako	漆樹
suna	晴朗
sunbrila	晴朗
sunleviĝo	日出
sunmakulo	太陽黑子
Suno	太陽
suno	日
sunsistemo	太陽系
sunsubiro	日落
sunvitroj	太陽鏡
ŝuo	鞋子
supera	超級
superhomo	超人
superi	超過
superjaro	閏年
superkondukanto	超導體
superlativo	最高級
supernatura	超自然
supernovao	超新星
superrego	霸權
superstiĉa	迷信
superstiĉo	迷信
superŝtupare	樓上
supervendejo	超市
supraĵo	錶面
supre	上面，樓上
sur	以上，之上，上，上面
surfaco	錶面
surgenuiĝi	跪下
surmeti	冠
surmeti ĉapelon	冠
suro	腿肚子
surpriza	驚人
surprizita	驚訝
surprizo	驚喜
surrenaj glandoj	腎上腺
surtuto	大衣
surverŝi	澆水，澆
survoje	在路上
suspektato	嫌疑人
ŝviti	流汗
ŝvito	汗，汗水
T-ĉemizo	體恤
tabako	煙草
tablo	桌，桌子
tablotuko	桌布
tabulludo	棋盤游戲，圖版游戲
tabulo	板子，木板
tagiĝo	黎明，黎
taglibro	日記
tagmezo	中午，午
tago	天，日
Taijuan	太原
taja skribo	泰文
Tajpeo	臺北
tajpisto	打字員
Tajvano	臺灣，台
taksi	估計
taksio	計程車
taksusarbo	紫杉，紅豆杉，紫杉樹，紅豆杉樹
taksuso	紫杉樹，紫杉，紅豆杉樹，紅豆杉
talento	才能
talio	腰部，鉈，腰
talpo	鼴，鼴鼠
tamarindarbo	羅望子樹，羅晃子樹，酸果樹
tamburo	鼓
tamen	不過
Tang-dinastio	唐朝
tantalo	鉭
tapiro	貘
tapiŝeto	攤子
tapiŝo	地毯
taso	杯子，茶杯，杯
taso da teo	一杯茶
taŭgi	適合
taverno	酒店
tearbo	茶樹
teatraĵo	劇，戲劇
teatraĵserio	連續劇
teatro	戲院
teda	無聊
teejo	茶館
tegi	覆蓋
tegilo	防護罩，覆蓋保護層
tegmento	屋頂
teknecio	鍀
tekniko	技術
teknologio	科技
teko	手提箱
tekruĉo	茶壺
tekstotraktado	文字處理
tektonarbo	柚木樹
tektono	柚木樹
telefon-numero	電話號碼
telefonbudo	電話亭
telefondrato	電話線
telefoni	打電話
telefoni al	打電話給
telefonkarto	電話卡
telefonlibro	電話簿
telefono	電話
teleregilo	遙控器
teleskopo	望遠鏡
televida programo	電視節目
televida serialo	電視連續劇
televida stacio	電視臺
televida teatraĵo	電視劇
televida teatraĵserio	連續劇，電視連續劇
televidaj novaĵoj	電視新聞
televidi	看電視
televidila ekrano	電視屏幕
televidilo	電視機
televido	電視
teluro	碲
temo	話題
temperamento	脾氣
temperaturo	溫度
tempio	太陽穴
tempo	時光，時，時間
tempomaŝino	時光機
temporala lobo	顳葉
Temuĝin	鐵木真
tendenco	趨勢
tendeno	腱，肌腱
tendo	帳篷
tenejo	倉庫
teni	拿著，維持
tenilo	把手
tenso	時態
teo	茶
teorio	理論
teorio de Praeksplodo	大爆炸理論
teorio de relativeco	相對論
tepoto	茶壺
Terakota Legio	兵馬俑
terbio	鋱
teritorio	領土
terkulturo	農業
termino	術語
termito	白蟻
termometro	溫度表
terni	打噴嚏
terno	噴嚏
tero	土地，土壤
Tero	地球
teroristo	恐怖分子
terpoma kaĉo	土豆泥，馬鈴薯泥
terpomo	土豆，馬鈴薯
terpomsenŝeliga tranĉilo	土豆削皮器
terrato	土鼠
Terstelo	土星
tertremo	地震
terura	壞透了
terure	要命
teruro	恐怖
testamento	遺囑
testo	考試
testudo	烏龜
tetaso	茶杯
Tezeo	忒修斯
tezo	論文
tia	那種，然，那樣，這麼
tial	因此，所以
tial ke	既然
tiam	當時
tiamaniere	那樣
Tian An Men-placo	天安門廣場
tibeta skribo	藏文
Tibeto	西藏，藏
tibio	脛骨
tie	那裏
tie kaj tie	到處，處處
tiel	這麼
tiele	那樣地，如此
tifao	香蒲
tifono	颱風
tigro	老虎，虎
tigrolilifloro	捲丹，捲丹花
tigrolilio	捲丹花，捲丹
tikli	搔癢
tiliarbo	椴樹，椴
tilio	椴，椴樹
tima	害怕
timema	膽怯的，害羞的
timi	怕，害怕，懼怕
timigi	嚇，使驚嚇，使害怕
timo	恐懼
timo	恐懼
timoteo	貓尾草，梯牧草
timpano	鼓膜
tineo	蛾，飛蛾
tinkturo	染料
tinuso	鮪魚，鮪
tio	那，那個
tio estas	那是
tio ne gravas	不要緊，沒關係
tio-ĉi	這，這個
tio-ĉi estas	這是
tiom bona	那麼好
tiom grava	那麼嚴重
tiotempe	當時
tiraneco	暴政
tirano	暴君
tirkesto	抽屜
tiroida glando	甲狀腺
titano	鈦
tiu	那
tiu speco de	那種
tiu-ĉi	這，這種，這個
tiuj	那些
tiuj-ĉi	這些
tiuokaze	那麼，那樣，在這種情況下
Tjanĝino	天津，津
tolerema	忍心
toleri	容忍，忍耐
tolmarko	洗衣店作的標籤
tolo	布
tombo	墳墓
tondilo	剪刀
tondro	雷聲
tondro kaj fulmo	雷電
tonsiloj	扁桃腺
torako	胸部
torio	釷
tornistro	背包
toŭfuo	豆腐
tradicia	傳統
traduki	翻譯
tradukisto	翻譯者
traduko	譯文
trafi	遇到
trafiko	交通
tragedio	悲劇
traĥeo	氣管
trajno	火車
traklisto	曲目
traktato	公約，條約
Traktato de Versajlo	凡爾賽和約，凡爾賽條約
trakti	處理，對待
traktoro	拖拉機
tramhaltejo	地鐵站
tranĉilo	一把刀
tranĉilo kaj forko	刀叉
tranĉodento	門齒
tranĉtabulo	砧板
transitiva verbo	及物動詞
transloĝiĝi	搬家
trapeza muskolo	斜方肌
traverŝilo	漏勺，濾器
tre	很
tre ĝena	很煩，很麻煩
treege	非常
tremi	顫抖
tremolarbo	楊，楊樹
tremolo	楊樹，楊
trezora	寶貴
tri	三
tri mil	三千
tri miliardo	三十億
tri miliono	三百萬
tri minutoj	三分鐘
Tri Reĝlandoj	三國
tria	第三
tria persono	第三人秤
triangulo	三角形
tribo	部落
tricent	三百
tricent mil	三十萬
tricent miliono	三億
tricepso	三頭肌
tridek	三十，卅
tridek du	卅二，三十二
tridek kvar	卅四，三十四
tridek kvin	三十五，卅五
tridek kvin minutoj	三十五分鐘
tridek mil	三萬
tridek miliono	三千萬
tridek minutoj	三十分鐘
tridek naŭ	三十九，卅九
tridek ok	三十八，卅八
tridek sep	卅七，三十七
tridek ses	三十六，卅六
tridek tri	三十三，卅三
tridek unu	卅一，三十一
trideka	第三十
trifoje	三次
trifolifloro	蓿，苜蓿，馬草，白花三葉草，酢漿草，苜蓿花，苜，三葉草
trifolio	酢漿草，三葉草，白花三葉草，苜，馬草，蓿，苜蓿花，苜蓿
trikapa muskolo	三頭肌
trinkaĵo	飲料
trinkejo	酒吧
trinki	喝
trioble	三倍
triono	三分之一
tritiko	小麥
Tritono	海衛一
triviala	粗魯
trivialaĵo	粗話
tro	太
troigi	誇張
Troja milito	特洛伊戰爭
trompi	欺騙
tropeolfloro	金蓮花，旱金蓮花，金芙蓉花，金芙蓉
tropeolo	金芙蓉花，金芙蓉，旱金蓮花，金蓮花
tropeza	超重
trovi	找到
trunka ĉelo	乾細胞
trunko	樹幹，幹，軀幹
truo	孔
TTT	萬維網
tubo	管
tuj	馬上，立刻
tuko	布，巾，布料
tulio	銩
tulipfloro	鬱金香花，鬱金香
tulipo	鬱金香，鬱金香花
tunelo	地道
turisto	觀光客
turmenti	欺負，欺
turnakvo	漩渦
turo	車
turto	斑鳩
tusi	咳嗽
Tut-Tera Teksaĵo	萬維網
tuta	全，都
tuta mondo	全世界
tuta nomo	全名
tutaj	全，都
tute	全部，完全
tutmonda	全球
tutmondaj	全世界
tutmondigo	全球化
tutnova	嶄新
Ŭej-Reĝlando	魏國
ujo	盒子
ulaĉo	鬼
ulmarbo	榆，榆樹
ulmo	榆，榆樹
ulno	尺骨
ulo	鬼
umbilika ŝnuro	臍帶
umbiliko	肚臍，臍
umearbo	梅，梅樹
umefloro	梅花
Unesko	聯合國教育科學文化組織，聯合國教科文組織，教科文組織
ungo	手指甲，腳趾甲
unika	獨特
universala ŝraŭbilo	活動扳手
universala ŝraŭbŝlosilo	活動扳手
universitato	大學
universo	宇宙
unu	一
unu la alian	互相…，相互…，互相，相互
unu minuto	一分鐘
unua	第一
unua persono	第一人秤
unuafoje	首度
unuafojo	第一次
unuĉelula	單細胞
unuĉelula organismo	單細胞生物
unufoje	一次
unufoje denove	再一次
Unuiĝintaj Nacioj	聯合國
unujara	一年生
unujara herbo	一年生草本
unukornulo	獨角獸
ununokta afero	一夜情
ununura	獨特
unuo	單位
unuoble	一倍
uranio	鈾
Urano	天王星，烏拉諾斯
urbdomo	市政府
urbego	都
urbestro	市長
urbeto	城鎮
urbo	都，都市，市，城市
urbocentro	市區，市中心
Urduo	烏爾都語
urinveziko	膀，膀胱，胱
urso	熊
urtiko	蕁，蕁，蕁麻，蕁麻
Urumĉio	烏魯木齊
utera cerviko	子宮頸
utero	子宮
utila	好用
Ŭu-Reĝlando	吳國
uvulo	小舌
uzanto	用戶
uzi	採用，吸，使用，用
uzi drogojn	吸毒
uzo	用途
vaga nervo	迷走神經
vagi	流浪
vagonaro	列車，火車
vagono	車廂，火車車廂
vagulo	流浪漢
vaksflava	蠟黃
vakskandelo	蠟燭
vakso	蠟
vakstolo	油布
valizo	行李箱
valora	寶貴
valoro	價值
vampiro	吸血鬼
vanado	釩
vango	面頰，頰，臉頰
vangobarbo	絡腮鬍子
vangofrapi	打耳光，拍擊，摑
vangofrapo	耳光，拍擊聲，摑
vangoharoj	絡腮鬍子
vangosto	顴骨，顴
vanta	虛榮
vaporo	蒸氣
varfo	碼頭
varma	熱，溫暖
varmbotelo	熱水瓶
varmo	熱量
Varsovia Kontrakto	華約組織，華沙條約組織，華約
Varsovia Traktato	華沙條約組織，華約，華約組織
vazlavilo	洗碗機
vazlavmaŝino	洗碗機
vejĉi-ludo	弈，圍棋
vejĉio	圍棋
vejno	靜脈
vekhorloĝo	鬧鐘
veki	叫醒，吵醒，使人醒來
vekiĝi	醒來，清醒，清醒過來
vendejo	店鋪，商店，店
vendi	推銷，售賣，售，販賣，賣，販
vendi drogojn	販毒
vendisto	店員，推銷員
vendredo	星期五，禮拜五，周五，五
venena gaso	毒氣
venena sumako	斷腸草，野葛，鉤吻
veneni	下毒
veneno	毒，毒藥
venĝo	報仇
veni	來
veni de	來自
veni por akompani	迎接
venigi	召喚，召來
venki	打敗，贏得
venkiĝi	敗仗，被打敗
venkinto	勝利者
venko	勝利
venteto	微風
venti	吹風
ventmuelejo	風車
vento	風
ventolilo	電風扇
ventra	腹部的，肚子的
ventriklo	心室
ventro	腹部，肚子
ventrodoloro	肚子痛
ventumi	扇，扇風
ventumilo	扇子，風扇
Venuso	維納斯，金星
vera	真正，真實
verba finiĝo	動詞詞尾
verba formo	動詞形式
verba frazero	動詞短語
verba radiko	動詞根
verbo	動詞
verda	綠色，綠
vere	真的
vere tre	真的很
vereco	真理
vergi	鞭打
vergo	棒，棍，杖，鞭子
verkisto	作者
vermo	蚓，蚯蚓，蚯
vero	真相，現實，真理
Versajla Packontrakto	凡爾賽和約
verŝajne	大概
verŝi	倒（流體等）
versio	版本
vertebra kolono	脊，脊柱
vertebro	椎骨
vertebrulo	脊椎動物
verukapro	疣豬
veruko	疣
vespermanĝi	吃晚飯
vespermanĝo	晚飯
vespero	晚，晚上
vesperto	蝙蝠，蝠，蝙
vespo	黃蜂
Vesta	維斯塔
vestarko	衣架
Vestfalia Packontrakto	威斯特法倫和約
veŝto	背心
vestoj	衣服
veterinformoj	天氣預報
vetero	天氣
vetkuri	賽跑
veturigi	開車
veturigi aŭton	開車
veturigisto	駕駛
veturilo	交通工具，車
veziketo	水皰
veziko	氣泡，水泡
vi	你們，你
vi mem	你自己，你們自己
vi pravas	你說得對
via	你的…，你們的…
via propra	你們自己的，你自己的，你們自己的
viando	肉
videobendo	錄影帶
vidi	見，見到，看見，看到
vidpunkto	觀念，觀點，看法
viktimo	被害人
vilaĝo	村莊
vin	你，你們
vinberarbo	葡萄樹，葡萄藤
vindi	包扎，包，裹
vindinfano	嬰兒
vindotuko	襁褓
vino	葡萄酒
vintro	冬天，冬
violfloro	紫羅蘭，紫羅蘭花
violo	紫羅蘭，紫羅蘭花
violono	小提琴
vipero	毒蛇
vipo	鞭子
vipuro	毒蛇
vir-	雄，公
vira	陽性，雄，公，男性
vira fenikso	鳳
vira genro	陽性
vira substantivo	陽性名詞
vira vorto	陽性詞
virbovo	公牛
virĉevalo	雄馬，公馬
virino	女人
virkato	公貓
virkoko	公雞
viro	男人
virŝafo	公羊
virseksa	男性，雄性，雄
virto	道德
viruso	病毒
viŝi	抹，擦
visit	拜訪，訪問，來訪
visko	槲寄生
visterifloro	紫藤花，藤蘿，藤蘿花，紫藤
visterio	紫藤花，紫藤，藤蘿，藤蘿花
viŝtuko	抹布
vitro	玻，璃，玻璃
vivaĵo	生物
viveca	活潑
vivi	生活
vivo	生命
vizaĝo	臉，面
viziteti	探望，順便來訪
Vjetnamio	越南
voĉdoni	投票
voĉo	語態
vojaĝanto	旅客
vojaĝi	旅游
vojaĝo	旅行，旅程
vojkruciĝo	路口
vojo	馬路，道路
vokala litero	母音字母
vokalo	母音，母音
vokativa kazo	呼格
vokativo	呼格
volframo	鎢
voli	想要，要
volo	意志，願望
volonta	自願
volonte	願意
vomi	嘔吐
vortaro	字典，詞典
vortklaso	詞類
vorto	字，詞，單字，單詞
vortodeveno	語源
vortoj	言語
vortordo	詞序，字序
vortprovizo	字彙
vosto	尾，尾巴
Vuhano	武漢
Vulkano	伏爾甘
vulkano	火山
vulpo	狐，狐狸
zebro	斑馬
Zeŭso	宙斯
zinko	鋅
zirkonio	鋯 
zono	皮帶
zorga	小心
zorgema	小心
zorgi	管，介意
