开放世汉词典

© 2013年 kaifangcidian.com
网址：http://www.kaifangcidian.com
本字典以创作共用“署名 3.0”许可协议授权发布（详见 http://creativecommons.org/licenses/by/3.0/）

［世界语］	［中文］

-eco	性
-ega	非常
-ema	趋向于
-ido	小
-ino	母，雌
-seksa	性
-u	应该
a.KE	公元前，西元前
abdomenaj muskoloj	腹肌
abdomeno	腹部，腹
abelejo	养蜂场
abelisto	养蜂人，养蜂家
abelkulturo	养蜂学，养蜂
abelo	蜜蜂
abelujo	蜂窝
abelvakso	蜂蜡
abiarbo	杉树，杉
abio	杉树，杉
abismo inter la generacioj	代沟
ablativa kazo	夺格
ablativo	夺格
aboco	字母表
abrikotarbo	杏树
absinto	苦艾，欧洲艾
absoluta	绝对
absolute ne	决不
abstrakta	抽象
aĉa	烂
acerarbo	枫树，枫
acero	枫，枫树
aĉetanto	客户
aĉeti	买
acida	酸
acida gusto	酸味
adampomo	喉结
adaptiĝi	适应
adiaŭ	再见，再会，别了
adiaŭa	离别的，告别的
adiaŭi	告别
adiaŭo	离别，告别
adjektiva finiĝo	形容词词尾
adjektivo	形容词
administra	行政
administranto	经理
administri	管理
admiri	佩服
adori	崇拜，礼拜
adrenalino	肾上腺素
adreso	地址
adverbo	副词
advokato	律师
aerarmeo	空军
aerlinio	航空公司
aero	空气
aerpoluo	空气污染
aerpoŝto	航空邮件
afabla	亲切
afero	事情
afikso	词缀
afiŝo	海报
afiŝtabulo	广告牌，布告栏
Afrika Unio	非盟，非洲联盟
Afrodito	阿佛洛狄忒
agado	活动
agema	主动
aglibero	活动的余地，活动的空间
aglo	老鹰
ago	动作
aĝo	年龄
agrabla	愉快
agrikultura socio	农业社会
agrikulturo	农业
Aĥila tendeno	跟腱
aj!	很痛，很疼，好痛
aĵo	东西
akaciarbo	金合欢树，金合欢
akacio	金合欢，金合欢树
akĉento	腔
akcento	重音
akcentsigno	重音符号
akcepti	接受
akcidento	事故
akiri	得到
akra	锐利
akrido	蝗，蝗虫
akronimo	首字母缩略词，首字母缩略字
akselo	胳肢窩，腋窝，腋
aktinio	锕
aktiva	主动
aktiva participo	主动分词
aktiva voĉo	主动语态
aktivo	主动语态
aktoro	演员
akurata	正确
akuzanto	原告
akuzativa kazo	直接受格，受格，宾格
akuzativo	直接受格，受格，宾格
akuzi	指控
akuzito	被告
akvario	水族馆
akvero	水滴
akvifolio	冬青
akvo	水
akvofalo	瀑布
akvolilifloro	睡莲花，睡莲
akvolilio	睡莲，睡莲花
Akvostelo	水星
al	朝向，到，对
Alaho	阿拉，安拉
albordiĝejo	码头
albumo	唱片，专辑
aldoni	加上
alergia	过敏
alfabeto	字母表
alfronti	面对
algoj	水藻，藻类
alĝustigi	调整
alia	另一个，不同，另，别的，另一，另外一个
alie	否则，不然
aligatoro	短吻鳄，鳄
alilandano	外国人
alilando	外国
alko	麋鹿，麋
alkoholo	酒精，酒
alkutimiĝi	适应，习惯了，习惯于
allogi	吸引
almenaŭ	至少
almozpetulo	乞丐
almozulo	乞丐
alnarbo	桤，赤杨，桤木，赤杨树，桤木树
alno	桤木树，桤木，赤杨，赤杨树，桤
alofono	音位变体
aloo	芦荟
alporti	带来，带领，带去，带
alta	乔，高，高大
altmaro	高潮
alto	身高
alttajdo	高潮
aluminio	铝
alveni	到达，达，到
alveni malfrue	姗姗来迟
alveno	到来
amanto	情人
amara	苦
amara gusto	苦味
amarilidfloro	孤挺花
amarilido	孤挺花
ambasadorejo	大使馆
ambasadoro	大使
ambaŭ	两者
ambicia	自负
ambicio	抱负
ambrosifloro	豚草，猪草，豕草
ambrosio	豚草，猪草，豕草
ambulanco	救护车
americio	镅
amfibio	两栖动物
ami	爱
amiko	友，朋，朋友
aminda	可爱
Amnestio Internacia	国际特赦组织
amnia fluido	羊水
amnia likvaĵo	羊水
amo	爱情
amorveka	性感
ampolo	电灯泡
amuza	好玩
amuzado	乐趣
amuzaĵo	娱乐
amuzo	乐趣
anagramo	变位词
analfabeta	不识字
analizi	分析
ananasarbo	凤梨树
anaso	鸭，鸭子
anĝelo	天使
angilo	鳗鱼，鳗
angioj	血管
anglalingvaj landoj	英语系国家
angulo	角落，角度
Anhujo	皖，安徽
animo	灵魂，心灵
ankaŭ	也
ankoraŭ	还是，依旧，依然，仍然，尚，还，依，犹，犹然，照旧，仍，照样
ankoraŭ ne	还没，尚未
ano	成员
anonci	宣布
anonco	广告
ansero	鹅
anstataŭ	而非
anstataŭigi	代替
antaŭ	以前，前，之前
antaŭ de la Komuna Erao	公元前
antaŭ la komuna erao 	西元前
antaŭ nelonge	近来，最近
antaŭbrako	前臂
antaŭe	前面，以前
antaŭjuĝo	成见
antaŭmanĝaĵo	主菜
antaŭmendi	预订
antaŭmolaro	前臼齿
antaŭo posten	前后颠倒，本末倒置
antaŭparolo	前言，序言
antaŭparto de kolo	颈
antaŭplano	前景
antaŭsento	预感
antaŭsigno	前兆，预兆
antaŭtagmeze	上午，早上
antaŭtuko	围裙
antaŭurbo	郊区，郊外
antaŭvidi	预见，期待
anteno	天线
antikva	古老
antimatter	反物质
antimono	锑
antineŭtrono	反中子
antipartiklo	反粒子
antiprotono	反质子
antonimo	反义词，反义字
aorto	大动脉，主动脉
aparataro	硬件
apartamento	公寓
aparteni al	属于，属
apenaŭ	几乎不，差点没有，勉强
apendico	阑尾
aperi	出现
apetito	胃口
aplaŭdi	拍手
apocino	毒狗草
Apolono	阿波罗
aprilo	四月
apro	野猪
apud	旁，旁边
apuda	隔壁
Araba Ligo	阿拉伯联盟，阿拉伯国家联盟，阿盟
araba parolo	阿拉伯话
araba skribo	阿拉伯文
araneo	蜘，蛛，蜘蛛
aranĝi	安排
arbaro	森林
arbedo	矮树
arbfolio	树叶
arbitracianto	裁判
arbo	树木
arboŝelo	树皮
arbradiko	树根
arbŝelo	树皮
arbsuko	树液
arbtrunko	树干
arekarbo	槟，槟榔树
areko	槟，槟榔树
Areso	战神阿瑞斯，阿瑞斯
aresti	逮捕
arĝenta	银
arĝentkolora	银，银色
arĝento	银
argilo	黏土
argono	氩
aristokrataro	贵族政治
arkeologio	考古学
arkitekto	建筑师
arma	武装
arma konflikto	武装冲突
armeo	陆军
armilo	武器
aroma	香
aromo	香气，口味
arseno	砷，砒
artaĵo	艺术品
artefarita satelito	卫星
Artemisa	阿尔忒弥斯
artemizio	艾草，艾
arterio	动脉
artiko	关节
artikolo	文，冠词，文章
artisto	艺术家
arto	艺术
asekuro	保险
aserti	主张
asfalto	柏油
asfodelfloro	日光兰，阿福花，日光兰花
asfodelo	日光兰，阿福花，日光兰花
asklepiado	马利筋
Asocio de Sudorient-Aziaj Nacioj	东南亚国家联盟，东盟
aspekti	看起来
aspekti simile	看起来很像
aspekto	外表
astato	砹，砈
asterfloro	紫苑花，紫苑
astero	紫苑，紫苑花
asteroido	小行星
astro	星体，天体
astronaŭto	太空人
Atena	雅典娜
atendejo	等候室
atendi	等，等待
atenton	小心
atestanto	目击者
atmosfera premo	气压
atoma nukleo	原子核
atomkerna centralo	核电厂，核能发电厂，核电站
atomkerna fisio	核分裂
atomkerno	原子核
atommaso	原子量
atomnumero	原子序数
atomo	原子
aŭ	或者，或
aŭdaci	胆敢
aŭdi	听见，听到
aŭgusto	八月
aŭriklo	心房
aŭskulti	听
aŭskultilo	听筒
aŭto	车子，车，车辆，汽车
aŭtobiografio	自传
aŭtobus	公共汽车，巴，巴士
aŭtobuso	公车
aŭtolitotrajno	卧车
aŭtolitvagonaro	卧车
aŭtomata	自动
aŭtomobilo	车子
aŭtonoma nerva sistemo	自主神经系统
aŭtonoma regiono	自治区
aŭtoro	作者
aŭtuno	秋，秋天
avantaĝo	好处
avara	吝啬
avelarbo	榛，榛树
aveno	燕麦
aventuristo	冒险家
aventuro	冒险
averaĝa	平均
averti	警告
averto	警告
avida	贪心
azalefloro	杜鹃花
azaleo	杜鹃花
azeno	驴子，驴
Azi-Pacifika Ekonomia Kunlaboro	亚太经合，亚洲太平洋经济合作组织，亚太经合组织
babilejo	聊天室
babili	聊天，聊，谈天儿，聊天儿，谈天，谈
bakforno	烤箱
bakisto	面包师傅
Bakko	巴克斯
bakterio	细菌
balailo	扫把
baldaŭ	不久
baleno	鲸鱼，鲸
balkono	阳台
balo	舞会
balzama abiarbo	香脂冷杉
balzama abio	香脂冷杉
bambuo	竹，竹子
bananarbo	蕉，香蕉树，芭蕉树
banĉambro	浴室
bandaĝo	绷带
bani sin	沐浴
banjano	榕，榕树
bankalsono	泳裤
banko	银行
bankuvo	浴缸
bano	沐浴
baobabarbo	猴面包树
baobabo	猴面包树
barakti	挣扎
barata parolo	印度话
barbo	胡，胡子
barilo	栅栏
bario	钡
basita sur	根据
bastono	拐杖
batalisto	战士
batalvenki	战胜
baza	基本
bazaro	市
bebo	小孩
bedaŭra	抱歉
bedaŭrinda	可惜，遗憾
bedaŭrinde	不幸地，遗憾地
begonifloro	秋海棠花，秋海棠
begonio	秋海棠花，秋海棠
bela	美，美丽
beladono	颠茄
beleta	漂亮
benko	板凳
berilio	铍
berkelio	锫
bestaĉo	怪物
besto	动物
betularbo	桦树，桦，白桦，白桦树
betulo	白桦，白桦树，桦，桦树
bezoni	需要，要，需
bibliotekisto	图书管理员
biblioteko	图书馆
bicepso	二头肌
biciklo	单车，自行车，脚踏车
bieno	农场
biero	啤酒
bildero	像素
bildkarto	明信片
bildo	图片
biliono	一万亿，兆，一兆，万亿
binara stelo	双星
biokemia procezo	生化过程
biologia ĉelo	细胞
birdo	鸟
bismuto	铋
blanka	白色，白
blanka libro	白皮书
blanka nano	白矮星
blanka sangoĉelo	白血球
blato	蟑螂，蟑
blogo	部落格，博客
bloketoj	积木
blua	蓝色，蓝
blua stelo	蓝星
boaco	驯鹿
boato	船
bobelo	气泡
bolpunkto	沸点
bombo	炸弹
bona	好
bongusta	好吃
bonŝanci	走运
bonŝanco	好运
bonvenigi	欢迎，迎接
bonvenigo	招呼，欢迎
bonvenon	欢迎！
bonvolu	请
borilo	钻孔机
boro	硼
borso	股票市场，证券交易所
botelkukurbo	葫，葫芦
botelo	瓶子
bovaĵo	牛肉
bovido	小牛
bovino	母牛
bovo	牛
brakhorloĝo	手表
brako	胳臂，胳膊，臂，手臂，臂
brakringo	手镯
brakseĝo	扶手椅
brakumi	拥抱
branĉo	树枝，枝
brando	白兰地
brazil-arbo	巴西红木
bremsoj	刹车
bretaro	柜橱
briketoj	积木
brila	明亮
Brita Imperio	大英帝国
Brita Regnaro	英联邦
bromo	溴
bronzo	青铜
brovo	眉，眉毛
brua	吵闹
brulavertilo	火警
bruliga	滚烫
brulligno	薪柴
bruna	咖啡色
brusto	脯，胸脯，胸
bubalo	水牛
budhano	佛教徒
budhismo	佛教
Budho	佛，佛陀
bufo	蟾蜍，蜍，蟾
buĝeto	预算
burĝono	花蕾，蕾，苞，花苞
buŝkavo	口腔
buŝo	嘴，嘴巴，口
buŝtuko	餐巾
butero	奶油
butikaro	商场
butiko	店铺
butikumi	买东西
butono	纽，纽扣，钮，电钮
ĉambro	房，房间
Ĉangĉuno	长春
Ĉangŝao	长沙
ĉapelo	冠，帽子
ĉapo	瓶盖
ĉar	因为，既然
ĉasi	追赶
ĉe	在
cedrarbo	香柏，雪松树，香柏树，雪松
cedro	香柏，雪松，香柏树，雪松树
ĉefa	主要，主
ĉefministro	总理
ĉefo	老板
ĉefpropozicio	主句
ĉefurbo	首都，京，都
ĉefverbo	主动词
cejanfloro	矢车菊，矢车菊花
cejano	矢车菊花，矢车菊
ĉeko	支票
ĉela dividiĝo	细胞分裂
ĉela histo	细胞组织，蜂窝组织
ĉeldividiĝo	细胞分裂
ĉelkerno	细胞核
celo	目标
ĉelo	细胞
cemento	水泥
ĉemizo	衬衫
Ĉengduo	成都
ĉeno	链条，链子
cent	百，一百
cent mil	十万
cent miliardo	千亿，一千亿
cent miliono	亿，一亿
centa	第一百
Centaŭro	人头马，半人马
centoble	百倍，一百倍
centono	百分之一
centra	中
centra nerva sistemo	中枢神经系统
centro	中间，中心
cerba trunko	脑干
cerbeto	小脑
cerbo	脑子，脑部
cerebelo	小脑
cerebro	大脑
ceremonio	仪式
cerio	铈
ĉerizarbo	樱，樱桃树
ĉerizfloro	樱花
certa	确定
certe	一定，定
certigi	确定
cerumeno	耳垢
cervo	鹿
ĉesi	结束，停止
cetere	而且
ĉevalejo	马厩，厩，马棚，马房
ĉevalido	小马驹，小马，驹，马驹
ĉevalino	雌玛，母马
ĉevalo	马，马，马
ĉevalpovo	马力
cezio	铯
ĉi-tie	这边，这里，这儿，这边儿
ĉi-tio	这个
ĉi-tio estas	这是
ĉi-tiu	这个，这种
ĉi-tiuj	这些
ĉia speco	哪种…都，每种
ĉiam	常，总是
ĉiamverda	常青，常绿
ĉiamverda arbaro	常青森林，常绿森林
ĉiamverda arbo	常绿树，常青树
Ĉiang Kai-ŝek	蒋介石
cico	乳头
ĉie	到处
ĉielarko	彩虹
ĉielkorpo	天体
ĉielo	天，天空，天堂
cigaredo	烟，香烟
cigaro	雪茄
cigno	天鹅
cikatra histo	疤痕组织
cikatro	疤痕
Ciklopo	独眼巨人
cikonio	白鹤
cikorio	菊苣
Ĉin-dinastio	秦朝
ĉina	华语，华，中，汉
ĉina hibiskfloro	朱槿，扶桑花
ĉina hibisko	朱槿，扶桑花
ĉina ŝako	象棋
ĉina signo	汉字，字
ĉina urbo Ŝanhajo	上海
cinamarbo	肉桂树
cinamo	肉桂树
cindro	灰
Ĉing-dinastio	清朝
Ĉinghajo	青海，青
ĉinia diantfloro	石竹，石竹花
ĉinia dianto	石竹，石竹花
Ĉinio	华，中，中国
ĉino	中国人
ĉio	一切
ĉioscia	无所不知
cipresarbo	柏树，柏
cipreso	柏，柏树
ĉirkaŭ	约，围着，左右，围绕着
ĉirkaŭi	围绕着，围着
ĉirkaŭiri	循环
cirko	马戏团
cirkonstanco	情况
cirkonstancoj	状况
citaĵo	引用文
citi	引用
citronarbo	柠檬树
ĉiu	都，每，每个人，每个
ĉiufoje	每次
ĉiuj	每个人都，大家
ĉiumomente	随时
civilizo	文明
Ĉongĉingo	重庆，渝
ĉu -os	会不会
ĉu bona?	好不好
ĉu eblas	能不能
ĉu estos	会不会
ĉu mi povas	能不能
ĉu mi rajtas	可不可以，我可不可以
ĉu povas	能不能
ĉu rajtas	可不可以
ĉu scipovas	会不会
ĉu vi povas	可不可以
ĉu vi scipovas	你会不会
ĉu vi scipovas ŝakludi?	你会不会下棋
ĉu...?	吗？ 
daktilarbo	枣椰树
daktilpalmo	枣椰树
damo	后
danci	跳舞
danĝera	危险
danĝero	危险
danki	谢谢，谢
dankon	谢谢，谢了，谢
dateno	资讯
dativa kazo	与格
dativo	与格
datreveno	周年纪念日
datumo	资讯
daŭra	持久的
daŭri	继续
daŭrigi	继续
daŭrigota	待续
daŭro	长短
dazipedo	犰，犰狳，狳
dazipo	犰，犰狳，狳
de	从
de la komuna erao 	西元
debati	辩论
decembro	十二月
decidi	决定
decido	决定
Dedalo	代达罗斯
defendanto	辨护人
defii	挑战
defio	挑战
defluiga tubo	输水管
dek	十
dek du	十二
dek kvar	十四
dek kvin	十五
dek kvin minutoj	十五分钟
dek mil	一万，万
dek miliardo	一百亿，百亿
dek miliono	一千万，千万
dek minutoj	十分钟
dek naŭ	十九
dek ok	十八
dek sep	十七
dek ses	十六
dek tri	十三
dek unu	十一
dek-dua	第十二
dek-kvara	第十四
dek-kvina	第十五
dek-naŭa	第十九
dek-oka	第十八
dek-sepa	第十七
dek-sesa	第十六
dek-tria	第十三
dek-unua	第十一
deka	第十
dekfoje	十次
deklari	表示
deklaro	声明
deklinaciebla	可以变化词尾，可以变格
deklinacio	格变化
dekoble	十倍
dekono	十分之一
Deksesa-Reĝlandoj	十六国
dekstre-maldekstre	左右
dekstro kaj maldekstro	左右
delfeno	海豚
deltoida muskolo	三角肌
deltoido	三角肌
demanda frazo	疑问句
demanda partikulo	疑问助词
demandi	问，询问，查询
demando	问题
demandvorto	疑问词
Demetera	得墨忒耳
demokratio	民主
demono	魔鬼
demonstrativo	指示代词，指示词
demonstri	示范
denove	再
densigi	浓缩
dentego	长牙，獠牙
dentisto	牙医
dento	牙齿，牙，齿
dentobroso	牙刷
dentokarno	牙床，齿龈，龈，牙龈
dentokrono	齿冠
dentopasto	牙膏
dentopikilo	牙签
dentoradiko	齿根
dentpikilo	牙签
dentrado	齿轮
deoksiribonuklea acido	脱氧核糖核酸，去氧核糖核酸
dependi de	依靠
deprimita	沮丧
destino	命运，命
detala	详细
detalo	细节
detektivo	侦探
detrui	毁灭
devena de	来自
deveni	来自，来源于，起源于
deveni de	来自，出生于
deveni el	来自
deveno	来源，起源
deverŝi	倒掉，滤掉
devi	必须，应该
devigi	逼迫
devizo	座右铭
devo	义务
devus	该，应，应该
dezerto	沙漠
deziregi	渴望
deziro	欲望，愿望
diafragmo	横隔膜
dialekto	方言
dialogo	会话
Diana	狄安娜
diantfloro	康乃馨，荷兰石竹，荷兰石竹花，康乃馨花
dianto	荷兰石竹，康乃馨，荷兰石竹花，康乃馨花
dieto	饮食
diferenco	差别
difinita artikolo	定词
difino	定义
diftongo	复合元音，双元音，复元音，双母音
digesta sistemo	消化系统
digesti	消化
digesto	消化
digno	尊严
dika	厚，粗
dika intesto	大肠
dikega	肥胖
dikfingro	大拇指
diktatoro	独裁
dimanĉo	星期日，星期天，日，礼拜天，礼拜日，周日
dinastio	朝代
Dinastio Ĉin	秦，秦朝
Dinastio Ĉing	清，清朝
Dinastio Ĝin	金，金朝
Dinastio Ĝoŭ	周，周朝
Dinastio Han	汉，汉朝
Dinastio Jŭan	元朝，元
Dinastio Ljaŭ	遼，辽
Dinastio Ming	明，明朝
Dinastio Ŝang	商，商朝
Dinastio Ŝja	夏，夏朝
Dinastio Song	宋朝，宋
Dinastio Suej	隋朝，隋
Dinastio Tang	唐朝，唐
dinosaŭro	恐龙
Dio	上帝
dioneo	捕蝇草
Dionizo	狄俄尼索斯
diplomiĝi	毕业
diplomo	文凭
direktanto	主任
direkti	指导
direktoro	主任
diri	告诉，表示，说
diserigebla	生物降解的，生物能分解的
diserigi	瓦解，分解
disfali	倒塌，崩溃
diskonto	折扣
diskuti	商量
disprozio	镝
disputi	争论，吵架
disrompi	打碎
distanco	距离
distingi	辨认，辨别
distrita	分心
disverŝi	溢出，流出
diveni	猜想
diversa	种种，综合
diversaj	各种
dividi	分开
DNA	脱氧核糖核酸，去氧核糖核酸
do	所以，那么
dogano	海关
doktoro	博士
dokumenta filmo	纪录片
dokumento	文件
dolĉa	甜
dolĉa gusto	甜味
dolora	痛，疼
dolorigi	伤害
doloro	痛，痛苦，疼痛
domego	豪宅
dometo	别墅
domo	房子，房
donacema	慷慨
donaco	礼物
doni	给
doni al iu telefonvokon	给…打电话
dormĉambro	卧室
dormema	想睡
dormi	睡觉
dormo	睡眠
dorno	刺
dorso	背部，背
dosiero	档案
dosierujo	文件夹
drako	龙
dramo	剧情片
dramserio	连续剧
drataro	配线，布线，接线
drato	电线
dratprovizado	配线，布线，接线
drattondilo	线材剪切机，线剪
drinkejo	酒吧
drinkemulo	酒鬼
drinki	喝酒
drinki alkoholon	喝酒
drinkulo	酒鬼
drogaĉoj	毒
drogemulo	毒虫
drogoj	毒
drogvendisto	毒贩，毒品贩子
droni	溺水
du	二，两
du mil	兩千
du miliardo	二十亿
du miliono	两百万
du minutoj	两分钟
dua	第二
dua persono	第二人秤
dubi	怀疑
ducent	二百，兩百
ducent mil	二十万
ducent miliono	两亿
dudek	廿，二十
dudek du	廿二，二十二
dudek kvar	廿四，二十四
dudek kvin	廿五，二十五
dudek kvin minutoj	二十五分钟
dudek mil	两万
dudek miliono	两千万
dudek minutoj	二十分钟
dudek naŭ	廿九，二十九
dudek ok	廿八，二十八
dudek sep	二十七，廿七
dudek ses	廿六，二十六
dudek tri	二十三，廿三
dudek unu	二十一，廿一
dudeka	第二十
dufoje	两次
duiliono	万亿，一兆，兆，一万亿
dujara	二年生
dujara herbo	二年生草本
dukapa muskolo	二头肌
dum	期间，时
dunaskitoj	双胞胎
dunganto	僱主
dungi	雇用，雇，聘请
dungito	雇员，员工
duoble	两倍
duodeno	十二指肠
duonhoro	半个钟头，半个小时
duonkondukanto	半导体
duono	一半，二分之一，半
duonvivo	半衰期
duonvokalo	半元音
duŝi sin	洗澡
ebena	平坦
ebenaĵo	平原，草原
eble	也不一定，不一定，可能，也许
ebleco	可能性
ebonarbo	乌木，黑檀木，黑檀树，黑檀木树，乌木树
ebono	乌木树，黑檀木树，黑檀木，乌木，黑檀树
ebria	喝醉了，醉了
ebrii	醉
ebriiĝi	喝醉
ebriulo	醉鬼
eburo	象牙
eĉ	连，尚且，尚，连…都
eĉ ne	都不
eĉ ne...	连…都不
eĉ pli	更
eĉ se	即使
eco	性质
Edipo	俄狄浦斯
eduko	教育
edzeco	婚姻
edziĝi	结婚
edziĝi kun...	跟…结婚
edziĝo	婚礼
edziniĝi	结婚
edziniĝo	婚礼
efektive	其实
efikeco	效率
efiko	作用，效果
egala	平等
ege	非常，要命
egoisma	自私
egoista	自大
eĥino	海胆
eĥo	回声
ejnŝtejnio	锿
ejo	地方
ekde	自从
ekinacfloro	紫锥花，锥光菊，紫锥菊，锥菊
ekinaco	锥菊，紫锥花，锥光菊，紫锥菊
ekipaĵo	设备
ekkuŝi	躺下
ekonomio	经济，经
ekrano	萤幕，屏幕
ekscita	刺激
ekscitita	兴奋
eksedziĝi	离婚
eksedziĝo	离婚
eksedziniĝi	离婚
ekskuzi sin	道歉
eksmoda	过时
eksperimento	试验
eksperto	专家
ekspliki	解释
eksplodi	爆炸
ekspozicio	博览会，展览会
ekstere	外面
eksterlanda	外国
eksterlandano	外国人
eksterna orela kanalo	外耳道
ekstra	额外
ekstrema	极端
ekstreme	非常
ekvilibro	平衡
ekvojaĝi	出发
ekzemple	譬如
ekzemplo	例子
ekzerckajero	练习簿
ekzisti	有，存在
el	出
eldonejo	出版社
eldoni	出版
eldono	版本
eleagno	茶枣花
eleagnofloro	茶枣花
elefanta dentego	象牙
elefanta ŝako	象棋
elefanto	大象，象，象
elekti	选择
elekto	选择
elektra	电
elektra butono	电钮
elektra cirkvito	电子线路，电路
elektra izolilo	电绝缘体
elektra kampo	电场
elektra kurento	电流
elektra rezistanco	电阻
elektra ŝargo	电荷
elektra seĝo	电椅
elektra sonorilo	电铃
elektra ventumilo	电扇
elektristo	电工
elektro	电，电力
elektromagneta kampo	电磁场
elektronika	电子
elektrono	电子
elementa lernejo	小学
elemento	元素
elfaro	成就
elirejo	出口
eliri	出去，出发，出
ellerni	掌握
ellitiĝi	起床
elmigri	移民
elparolado	发音
elparoli	发音
elparoligi	说出
elparolo	发音
elpenso	观念
elporti	忍受
elsaluti	登出
elsendi	广播
elspezi	花费，花
elspezo	收支
elspiri	吐气
elŝuti	下载，下
eltrovi	发明
eltrovo	发明
eluzi	用尽，耗尽，用完
eluziĝi	磨损，耗损，消耗
eluzita	磨损了的，消耗了的
elveni	出来
elverŝi	倒出
emajlo	珐琅，琅，珐琅质，珐
embarasa	尴尬
embarasita	尴尬
embria histo	胚胎组织
embria trunka ĉelo	胚胎干细胞
embrio	胚胎
emeritiĝi	退休
emfazi	强调
emi	趋向于
emo	趋势，趋向
en	在，入
en ĉiu okazo	不管怎样，无论如何
en la okazo se	万一，如果是那样的话
enciklopedio	百科
endokrina sistemo	内分泌系统
energio	能量
enhavebleco	容量
enhavo	内容
enirejo	入口
eniri	入
enkadrigi	框起来
enketo	调查
enklasigi	归类
enlitiĝi	上床
enmigri	移民
enmiksiĝi en	干涉
enmiksiĝo	干扰
enoterfloro meza	待宵草，月见草
enotero meza	月见草，待宵草
enregistri	注册
ensaluti	登入
enskribi	注册
enŝlosi	上锁
enspezo	收入
enspiri	吸入
entenaĵo	内容
entreprenisto	企业家
entuziasma	热情
enveni	进来
enverŝi	倒进，倒入
enviciĝi	排队
envii	羡慕
enzimo	酵素
epigloto	会厌软骨，会咽，会咽软骨，会厌
epoko	时代
erao	纪元
erari	犯错
eraro	误，错，错误
erbio	铒
erikfloro	石南花
eriko	石南花
erinaco	猬，刺猬
eritrocito	红细胞，红血球
ero	屑，粒，小组件
escepto	例外
eskalatoro	自动扶梯
eskapi	逃脱
Esperanto	世界语
esperi	希望
esprimi	表达
esprimo	术语，说法
esti	有
esti hejme	在家
esti miskomprenata	被误解
esti nur	只是
estontaj generacioj	后代
estonteco	未来
estonto	未来
estro	领袖
etendi	膨胀
eterne	永远
etfingro	小指
etikedo	标签
eŭkaliptarbo	桉树，桉
eŭkalipto	桉树，桉
eŭkarioto	真核生物
eŭro	欧元
Eŭropa Liberala Demokrata Partio	欧洲自由民主与改革党
Eŭropa Parlamento	欧洲议会
Eŭropa Popolpartio	欧洲人民党
Eŭropa Unio	欧洲联盟，欧盟
Eŭropaj Demokratoj	欧洲民主党
eŭropio	铕
evidenta	明显
eviti	逃避
evolui	发展
evoluigi	发展
evoluigita	发达
evoluo	进化
ezofago	食道
fabelo	童话故事，童话
fabo	蚕豆
fabrikejo	工厂
facila	易，不难，容易
facile	轻易
facilrompa	脆弱
fagarbo	山毛榉，山毛榉树
fago	山毛榉，山毛榉树
fajlilo	锉刀
fajraĵo	烟火
fajrejo	灶台，炉边
fajrero	火花，火星
fajrilo	打火机
fajro	火
fajropoto	火锅
Fajrostelo	火星
fako	科目
fakte	其实
fakto	事实
fakulo	专家
falango	指骨
faldi	折叠
falfolia	落叶
falfolia arbo	落叶树
fali	落，掉了
fali suben	落下来
falko	鹰，隼，雕
falŝa akaciarbo	洋槐树，刺槐，刺槐树
falŝa akacio	刺槐树，洋槐树，刺槐
fama	著名，有名，闻名
familia nomo	姓，姓氏，氏
familio	家人
famo	名
fantomo	鬼魂，鬼
farbo	颜料，染料
fari	制造，做
faringo	咽喉，咽
farmacio	药房
farmisto	农人
farmo	农场
fazo de materio	物态，相，相态
febra	发烧的
febri	发高烧，发烧
febro	高烧
februaro	二月
fekaĵo	粪便，大便
fekaĵputo	粪坑，化粪池
feki	拉屎，大便
feko	粪便，大便
fekunda	肥沃
feliĉa	快乐，幸福
feliĉeco	幸福
feliĉo	幸福
femura arterio	股动脉
femuro	大腿
femurosto	大腿骨
fendaĵo	裂缝，裂口
fendi	分开，裂开
fendiĝi	分裂，迸裂
fenestro	窗口
fenestrokadro	窗框
fenikoptero	红鹤
feniksino	凰
fenikso	凤，凤凰
fenomeno	现象
fera	铁的，铁制的
ferdeko	甲板
ferdrato	铁线
ferio	假日
fermentinta toŭfuo	豆乳
fermi	关闭，闭，关
fermi la pordon	关门
fermio	镄
fero	铁
ferumi	钉蹄铁
fervojo	铁路
festeno	宴，宴会
festi	庆祝，过节
festo	节日，庆祝活动
feto	胎，胎儿
fi	可耻
fia	贱，下流，可耻的
fibro	纤维
fidi je	信任
fido	信仰，信赖
fiera	骄傲
fifama	臭名昭著，臭名远扬，恶名昭彰
figarbeto	印度橡树，印度榕，印度橡胶树，印度榕树
figarbo	无花果树
fiinsektoj	害虫
fikopii	抄袭
filiĉo	子
filikoplanto	羊齿
filmo	片，电影，片子
filo	子
filodendrono	蘗，喜林芋，黄蘗
filozofio	哲学
filozofo	哲学家
filtrilo	过滤器
finaĵo	词尾
fine	终于，最后
finfine	终于
fingra osto	指骨
fingringo	顶针
fingro	手指，指
fingroartiko	指关节
fingropremaĵo	手印，指纹
fini	结束
finiĝo	词尾
fipetola	不羁，肆无忌惮，无拘无束
fipetolemo	放肆，无拘无束
firakonto	下流的故事
fiŝo	鱼
fiŝvergo	钓杆，钓鱼杆
flamengo	红鹤
flankokupo	嗜好
flava	黄，黄色
flava kupro	黄铜
flava nano	黄矮星
flava stelo	黄星
flegisto	护士
fleksebla	弹性
fleksio	词形变化
fleo	梯牧草，猫尾草
floro	花朵，花
flua	流利
fluaĵo	流体
flughaveno	机场，飞机场
flugi	飞行
flugilo	翅，翼，翅膀
flugmaŝino	飞机
fluoro	氟
fluso	涨潮
fluto	长笛
Fobo	火卫一
foje	次
foko	海豹
folio	叶，叶子，树叶
fonemo	音位，音素
fonetiko	语音学，发音学
fono	背景
fonologio	音韵学
fonto	来源
forgesi	忘记，忘
foriri	离，离开
forĵetaĵo	废物
forĵeti	丢掉
forĵetindaĵo	废物
forkuri	逃脱
formala	正式
formiko	蚂蚁，蚁，蚂
formo	形状
formortinta	绝种
forno	炉灶，炉
forpreni	拿走
forsitifloro	连翘花，连翘
forsitio	连翘花，连翘
forta	强
forte	强烈
forto	力气
forumo	论坛
forviŝi	擦掉
fosforo	磷
fosmaŝino	挖土机
foti	拍照
fotilo	照相机
foto	照片
fotografi	拍照
fotosintezo	光合作用
fraksenarbo	灰树，梣树，白蜡树，梣
frakseno	白蜡树，灰树，梣树，梣
francio	钫
frapi	打
frapi sur la pordon	敲门
fraŭla	独身
frazelemento	句子成分
frazero	词组，片语
frazo	片语，短语，句子，词组
fremda	陌生
fremdulo	陌生人
freneza	疯狂
frenezulejo	疯人院
frenezulo	疯人，狂人，疯子
freŝa	新鲜
fridujo	冰箱，电冰箱
fromaĝo	奶酪
frostigi	冰冻
frostigilo	冷冻库
frostigita	冷冻
frotado	摩擦
froto	摩擦
frua	早
fruktarbo	果树
frukto	水果
fruktodona	肥沃
frunta lobo	额叶
frunto	额，额头
fuĝi	逃走
Fuĝjano	闽，福建
Fuĝoŭo	福州
fulmo	电，闪电
fulmotondro	雷电
fumi	吸，抽烟，抽，抽烟，吸烟
fumi cigaredon	抽烟
fumo	烟
fundo	基础
funelo	漏斗
funkcii	起作用
funkciigi	操作
funkcio	功能
furorlibro	畅销书
furzi	放屁
furzo	屁
fuŝi	搞砸，弄糟，搞坏
fusilo	步枪
fuŝita	糟糕的，坏了的
fuŝkontakto	短路
fuŝpalpi	摸索，弄乱，摸弄
futura tempo	将来时
fuzio	核聚变，核融合
gado	鳕鱼，鳕
gadolinio	钆
gaja	活泼
Gaja	盖娅
gajni monon	赚钱
gala veziko	胆囊，胆
galaksio	星系
Galaksio	银河系，银河
galiumo	镓
galveziko	胆，胆囊
gambo	腿
ĝangalo	丛林
Gansuo	甘，甘肃
ganto	手套
garantii	保证
ĝardeno	花园
gardisto	卫兵
gasigi	气化
gaso	瓦斯，气体
gastama	好客
gasti	做客
gasto	客人
gazeto	新闻报纸，报纸，报
gazono	草坪
geedziĝi	结婚
Ĝeĝjango	浙江，浙
gejo	同志
geko	壁虎
ĝemeloj	双胞胎
gemo	宝石
ĝena	麻烦，烦
ĝenaĵo	麻烦
generacio	一代，代
ĝenerala asembleo	大会
Ĝenerala Relativeco	广义相对论
ĝenerala sekretario	秘书长
Ĝenerala Sekretario de UN	联合国秘书长
Ĝengĝoŭo	郑州
Ĝenĝis Ĥano	成吉思汗
ĝeni	麻烦，打扰，烦
genitiva kazo	属格
genitivo	属格
geniulo	天才
geno	基因
ĝeno	麻烦
genro	性
ĝentila	客气，礼貌
genuo	膝盖
geografio	地理
gepardo	猎豹
gepatra lingvo	母语
geranifloro	老鹳草
geranio	老鹳草
germanio	锗
gerundo	动名词
gesto	手势
ĝi	它
ĝia	它的
ĝia propra	它自己的
giganta	巨大
giganta sekvojo	世界爷树，世界爷，巨杉，巨杉树
giganta stelo	巨星
giganto	巨人
gimnastiko	体操
ĝin	它
Ĝin-dinastio	金朝
Ĝingis-Ĥano	成吉思汗
ginkarbo	银杏树
ginko	银杏树
gipso	石膏
ĝirafo	长颈鹿
ĝis	拜拜
ĝis la revido	再见
ĝis nun	目前为止
gitaro	吉他
Ĝjangŝjio	赣，江西
Ĝjangsuo	江苏，苏
Ĝjilino	吉，吉林
Ĝjinano	济南
glacimonto	冰山
glacio	冰
gladilo	熨斗
glandoj	腺
glaso	杯子，杯，玻璃杯
glaso da akvo	一杯水
glata	润滑
glavingo	剑鞘
glavo	剑
glitveturilo	雪橇
globskribilo	圆珠笔
gluaĵo	胶水
glukozo	葡萄糖
glumarko	贴纸
glutea muskolo	大臀肌
gluteo	臀，臀部，屁股
gluti	吞
ĝoja	乐，高兴
ĝojo	乐
goo	围棋
gorĝa pomo	喉结
gorĝo	喉，喉咙，咙
Ĝoŭ-dinastio	周朝
gramatika esprimo	语法术语
gramatiko	文法，语法
granatarbo	石榴树
granda	大
Granda Eksplodo	大爆炸
granda orcino	虎鲸
granda pando	大猫熊，大熊猫
grandeco	大小
grandparte de	大部分的
grandvalora	贵重
grapfruktarbo	葡萄柚树
grasa	肥，胖
grasa histo	脂肪组织
grasdika	肥胖
grasega	肥胖
gratulon	恭喜
grava	重要，严重
graveco	重要性
gravega	非常重要
gravita kampo	重力场，引力场，万有引力场
gravito	重力，引力，重力相互作用，万有引力
greka parolo	希腊话
grilo	蟋蟀，蟋，蟀
griza	灰，灰色
grundo	土壤
gruo	鹤
grupeto	小组
grupigi	组
grupo	小组，团体
Gŭangdongo	粤，广东
Gŭangŝjio	桂，广西
ĝui	享，享受
Gujĝoŭo	黔，贵州
Gujjango	贵阳
gumarbo	印度榕树，印度榕，印度橡胶树，印度橡树
gumo	橡皮擦
ĝusta	对，正确
ĝustigi	调整
gusto	口味，味，味道
gustumi	尝，尝试
gvidi	指导
gvidisto	导游
Hadeso	哈迪斯
hafnio	铪
Hajkou	海口
hajlero	雹石，冰雹
hajlo	冰雹
Hajnano	琼，海南岛，海南
halti	停止
Han-dinastio	汉朝
hanĉino	汉人
Hangĝoŭo	杭州
hara foliklo	毛囊
hararo	头发，发
Harbino	哈尔滨
harfoliklo	毛囊
harmonia	和谐
harmonio	和谐
haro	头发，发，一根头发，毛
harplektaĵoj	辫，辫子
haŭto	皮肤
haŭto	肤，皮，皮肤
haŭtveziketo	水疱
haveno	海港
havi	有
havi bonŝancon	走运
havi nur	只有
hazarda	偶然
Hebejo	河北，冀
hebrea parolo	希伯来话
hedero	常春藤
Hefejo	合肥
Hefesto	赫斐斯托斯
hegemonio	霸权
heĝo	灌木
Hejlongĝjango	黑，黑龙江
hejme	在家
hejmo	家
hejmtasko	作业，功课
helena mitaro	希腊神话
helena mitologio	希腊神话
heliantfloro	向日葵，葵花，葵
helianto	向日葵，葵，葵花
heliko	蜗牛，蜗
heliumo	氦
helpanto	帮手，助理
helpi	帮忙
helpo	帮助
helpverbo	助动词
hemisfero	半球
hemoglobino	血红素，血红蛋白，血色素
Henano	河南，豫
hepato	肝脏，肝
Hera	赫拉，天后赫拉
Herakleo	海格力斯，赫拉克勒斯
herbo	青草，草，草本
heredaĵo	遗产
heredanto	继承人
heredi	继承
Hermeso	赫耳墨斯
heroo	英雄
Hestia	赫斯提亚
hibiskfloro	木槿，槿
hibisko	槿，木槿
hidrargo	汞，水银
hidrogeno	氢
hieraŭ	昨，昨天
higieno	卫生
hinduismo	印度教
hiperiko punktita	贯叶连翘
hipnoto	催眠术
hipofizo	脑垂腺
hipokampo	海马
hipokaŝtanarbo	七叶树，马栗树
hipokaŝtano	马栗树，七叶树
hipopotamo	河马
hirudo	蛭，蚂蟥，水蛭，蚂
hirundo	燕，燕子
hiskiamo	天仙子，莨菪
histo	组织
historio	史，历史
histriko	豪猪
hobio	嗜好
hodiaŭ	今，今天
hogo	火锅
holmio	钬
homa korpo	躯，人体，身躯
homamaso	人群
homaro	人类
homo	人，人类
homportilo	担架床
honesta	诚实
Honkongo	香港，港
Honkongo Speciala Administra Regiono	香港特别行政区
honta	惭愧
horaro	时间表，行程
hordeo	大麦
horizonto	地平线
horloĝeto	手表
horloĝo	时钟，钟
hormona malekvilibro	荷尔蒙失衡
hormono	荷尔蒙
ĥoro	唱诗班，合唱团
horo	时，小时，钟头
hortensifloro	绣球花，洋绣球花，紫阳花，八仙花
hortensio	紫阳花，绣球花，八仙花，洋绣球花
hotelo	饭店
Hubejo	鄂，湖北
hufferi	钉蹄铁
huffero	马蹄铁
hufo	蹄
Huhehaŭteo	呼和浩特
humida	潮湿
humoro	脾气，心情
humura	幽默
humuro	幽默感
Hunano	湖南，湘
hundo	狗
iafoje	有时候
iam	曾经
ida	小
idaro	子，子孙，后代
ideala	理想
identa	相同
ideo	主意
ideografiaĵo	字
idiotisma esprimo	习惯用语
idiotismo	习惯用语，成语，习惯语
ido	子，孩子
idolo	偶像
ie ajn	哪里都
igi	使，导致，令
iĝi	成，变，成为，变成
ignori	忽视
Ikaro	伊卡洛斯
ila kazo	工具格
ili	她们，他们，它们
ili mem	他们自己
ilia	她们的，他们的，它们的
ilia propra	它们自己的，她们自己的，他们自己的
ilin	他们，它们，她们
ilo	工具
iluziisto	魔术师
iluzio	幻觉
imagi	想象
imago	想象力
imamo	阿訇，訇
imiti	模仿
imperativa formo	命令式
imperativa frazo	命令语句
imperativa modo	祈使语气，命令语气
imperativo	祈使
imperiestro	帝，皇帝，皇
imperio	帝国
impona	给人深刻印象的，令人难忘的，令人印象深刻的
imposto	税
impreso	印象
impulsiĝema	冲动
imuna sistemo	免疫系统
ina	阴性，母，女性，雌
ina fenikso	凰
ina genro	阴性
ina substantivo	阴性名词
ina vorto	阴性词
incizivo	门齿
indekso	索引
indikativo	陈述式
indikativo modo	直述语气，陈述语气，直说法
indio	铟
indo	价值
Indonezio	印尼，印度尼西亚
industrio	工业
infaneto	婴儿，小孩
infano	孩子
infekta	传染
infekti	感染
infero	地狱
infinitiva modo	不定式语气
infinitiva verbo	动词不定式
infinitivo	不定式
informaĵo	资料
informi	报导
informo	资料
inĝeniero	工程师
ingredienco	成分
injekto	注射
inkluzive	包括，包括
inkluzive de	包括，包括
inko	墨水
inkŝpruca presilo	喷墨打印机
ino	女人
inseksa	雌性，雌，女性
insekto	虫，虫子，昆虫
insisti	坚持
inspiraĵo	灵感
inspiro	灵感
instiga kaŭzo	动机
instinkto	本性
instruado	教育
instrui	教书，教
instruisto	老师，师
instrumentala kazo	工具格
instrumentalo	工具格
instrumento	仪器
insulo	岛屿
insulti	侮辱
insulto	侮辱
intence	故意
intence aŭ senintence	有意无意
inter	之间
interbatiĝi	打架
interesa	有意思，有趣
interesega	很有意思
intereso	兴趣
interjekcio	感叹词
intermeti	干涉
intermeto	干扰
Interna Mongolio	内蒙古，蒙
internacia	国际
Internacia Atom-Energia Agentejo	国际原子能机构
Internacia Banko por Rekonstruado kaj Disvolvado	国际复兴开发银行
internacia juro	国际法
Internacia Krima Kortumo	国际刑事法庭
internacia leĝo	国际法
Internacia Mona Fonduso	国际货币基金组织，国际货币基金
Internacia Movado de la Ruĝa Kruco kaj Ruĝa Krescento	国际红十字与红新月运动
internacia organizaĵo	国际组织
Internacia Organizo por Normigado	国际标准化组织
interne	里面
interogativo	疑问代词
interparolado	对话
interpunkcia signo	标点符号
interpunkcii	标点
interpunkcio	标点法
interreto	互联网
interŝanĝi	交换
intesto	肠，大肠
intima	亲
intuicio	直觉
investi	投资
inviti	邀请
io ajn	什么都
iom da	一点儿，一点
iom da akvo	一点水，一点儿水
iom da mono	一点钱，一点儿钱
iomete	一点点
ipomefloro	喇叭花，牵牛花
ipomeo	喇叭花，牵牛花
iri	去
iridfloro	鸢尾花
iridio	铱
irido	鸢尾花
iriso	虹膜
Islama	回
islamano	清真教徒
islamo	伊斯兰教，回教，清真教
iterbio	镱
itrio	钇
iu ajn	谁都，任何
iu tago	一天，有一天
iufoje	有时候
iuj	一些，些
izola	孤立
izolilo	绝缘体
izotopo	同位素
ja	确，的确，确实
jaguaro	美洲豹
Jalta Konferenco	雅尔塔会议
ĵaluza	妒嫉
jam	已经，已
jam ne	不再
jam ne...	不再…了
januaro	一月
japana	和
japana parolo	日本话
Japanio	日本
jarcento	世纪
Jarcento de la Lumoj	启蒙时代
jarlibro	年鉴，年刊
jaro	年
jasmenfloro	茉莉花，莉，茉，茉莉
jasmeno	茉莉花，莉，茉莉，茉
ĵaŭdo	星期四，周四，四，礼拜四
Jazono	伊阿宋
jenaj	下列
jes	是的
ĵeti pilkon	扔球
jido	意第绪语
Jinĉŭan	银川
jodo	碘
Johana herbo	贯叶连翘
ju pli granda, des pli bona	越大越好
ju pli malgranda, des pli bona	越小越好
ju pli malmultaj, des pli bona	越少越好
ju pli multaj, des pli bona	越多越好
ju pli... des pli...	越…越…
Jŭan-dinastio	元朝
judismo	犹太教
juĝejo	法庭
juĝisto	法官
juglandarbo	核桃树，胡桃树
jugulara vejno	颈静脉
julio	七月
juna	年轻
Junano	滇，云南
junio	六月
juniperarbo	桧树，桧木，杜松树，桧，刺柏，桧木树，刺柏树，杜松
junipero	杜松树，刺柏，桧树，桧，桧木树，桧木，刺柏树，杜松
junko	灯心草
Junona	朱诺
junulo	青年
Jupitero	朱庇特，木星
jupo	裙子
ĵurio	陪审团
ĵuristo	陪审员
ĵurnalisto	新闻记者，记者
ĵurnalo	报纸
juro	法
ĵus	刚刚，刚，刚才
justa	公平
justeco	正义
kablo	钢索
kadmio	镉
kadro	框架，结构，框
kafejo	咖啡厅，咖啡馆
kafeterio	食堂
kafo	咖啡
kaĝo	笼子
Kaira Deklaracio	开罗宣言
kaj	且，与，同，而，而且，以及，和，及
kakto	仙人掌
kalafloro	马蹄莲花，白海芋，水芋花，海芋，荷兰海芋，海芋花，水芋，马蹄莲，白海芋花
kalao	水芋花，水芋，海芋，白海芋，马蹄莲花，荷兰海芋，白海芋花，马蹄莲，海芋花
kalcio	钙
kalemburo	双关语
kalendaro	历，日历
kalendulfloro	万寿菊花，万寿菊，金盏花
kalendulo	万寿菊，金盏花，万寿菊花
kalifo	回教主
kalifornio	锎
kalio	钾
kalkano	脚跟
kalkulilo	计算机
kalo	鸡眼
kalsono	内裤
kamarado	同志
kameleono	变色龙
kamelifloro	茶花，山茶花
kamelio	山茶花，茶花
kamelo	骆驼，驼
kameno	壁炉
kamentubo	烟囱
kamforarbo	樟树，樟
kamioneto	货车
kamiono	卡车
kamomilfloro	甘菊花
kamomilo	甘菊花
kamparano	农民
kampodometo	别墅
kampulo	农人
kanabo	麻，大麻
kanalo	频道，电台
kandelingo	烛台
kandelo	蜡烛
kanino	犬齿
kano	芦苇，芦，苇
kanti	唱歌
kantisto	歌手
kanto	谣，歌曲
Kantono	广州
kantstilo	腔
kapableco	能力
kapablo	能力
kapacitanco	电容
kapacito	容量
kapdoloro	头痛
kaphararo	头发
kaphaŭteroj	头皮屑
kapitulaci	投降
kapjesi	点头
kapkuseno	枕头
kapnei	摇头
kapo	首，头部，头
kapro	山羊
kaptilo	陷阱
kaptuko	头巾
kapturna	头晕
kapturniga	令人晕眩，令人头晕
karaktero	性
karbono	碳
kardiovaskula sistemo	心血管系统
kardo	蓟
kariero	事业，生涯
kariofilo	丁香
karobarbo	稻子豆
karotida arterio	颈动脉
karpaj ostoj	腕骨
karpo	鲤，鲤鱼
kartilago	软骨
karto	地图，卡片，片
kartono	硬纸板
karulino	女朋友
karulo	男朋友
kaŝita	隐
kasko	头盔
kaŝludo	捉迷藏
kaŝtanarbo	栗子树，栗树
kastelo	城堡
kastoro	海狸
kata mento	猫薄荷
katastrofo	浩劫
katido	小猫
katino	母猫
kato	猫
katolikismo	天主教
kaŭĉukarbo	橡胶树
kaŭĉuko	橡胶
kaŭri	蹲下
kaŭzi	导致
kaŭzo	原因，理由
kava	中空
kavetoj	酒窝
kavo	洞穴，窟，窿，洞，窟窿，腔，穴
kazino	赌场
kazo	格
KE	公元，西元
kelka	几
kelkaj	几个
kelkfoje	几次
kelkoble	几倍
kelo	地下室，地窖
kemia elemento	化学元素
kemia simbolo	化学符号
kemio	化学
kernofendado	核分裂
kernofrukto	核果
kesto	箱
kia	什么样，哪种
kia speco	哪种，哪一种
kial ne	为什么不
kial?	为什么
kialo	理由
kiam	时，的时候
kiam?	什么时候
kie	哪里
kiel	怎么
kies	谁的
kinejo	电影院
kineta energio	动能
kio	哪个
kio?	什么
kiom	多少
kiom aĝa	几岁
kiom da	多少
kiom multa	多少
kioma horo estas?	几点钟？，几点？
kirurgo	外科医生
kisi	接吻，亲嘴，吻，亲，亲亲
kiu speco de	哪种
kiu?	谁
klara	清，清楚
klare	明明
klarigi	解释
klarigo	说明
klasĉambro	教室
klavaro	键盘
klaviklo	锁骨
klavo	键
klematidfloro	铁线莲花，铁线莲
klematido	铁线莲花，铁线莲
kliento	客户，顾客
klimato	气候
kloro	氯
klorofilo	叶绿素
kloroplasto	叶绿体
kloŝfloro	风铃草，风铃草花
knabino	女孩子
knabo	男孩子
koalo	无尾熊
kobalto	钴
kobro	眼镜蛇
kodo	密码
kodumulo	黑客
kojlo	结肠
kojnodento	犬齿
kokaĵo	鸡肉
kokcigo	尾骨
kokcinelo	瓢虫
koketi	调情
kokido	小鸡
kokino	母鸡
koko	鸡
kokosarbo	椰，椰子树
kokso	髋骨，髋
kolĉeno	项链
kolegio	学院
kolera	生气
koleregigi	气死
kolerigi	惹生气
kolero	气
kolhararo	鬃，马鬃，鬃毛
kolhararo de ĉevalo	马鬃
kolo	脖，项，脖子，颈，颈项
kolombio = niobo	钶
kolombo	白鸽
kolonio	殖民地
koloro	颜色
koltuko	围巾
kombilo	梳子
komedio	喜剧
komenci	开始
komerci	做生意
komerco	商业
kometo	彗星，扫帚星
komforta	舒服
komitato	委员会
kompanio	公司
komparacia grado	比较级
komparativa adjektivo	比较级形容词
komparativo	比较级
kompaso	指南针
kompati	同情
kompatinda	可怜
komplemento	补语
kompleza	亲切
komplezema	亲切
komplika	复杂
komplimento	恭维
kompoŝti	堆肥
kompoŝto	堆肥
komprenaĵo	概念
kompreneble	当然
kompreneco	理解力
kompreni	了解，懂，了，理解，会，明白
komputilo	电脑
komuniki	沟通
komuniko	沟通
komunismo	共产主义
komunumo	社区
Komunumo de Nacioj	英联邦
koncedi	承认
koncepto	概念，观念
koncerto	演唱会
kondiĉa frazo	条件句
kondiĉa modo	条件语气
kondiĉa propozicio	条件从句
kondicionalo	条件语
kondiĉo	条件
kondukanto	导体
konduki	领导
konduktilo	导体
konduto	行为
konfesi	承认
konflikto	冲突
konfuzita	迷惑
koni	识，认，认识
konio makula	毒胡萝卜，毒堇
konjunkcio	连词
konkurado	竞争
konkuri	竞争
konkurso	比赛
konscienco	良心
konscio	知觉，意识
konsenti	同意
konservema	保守
konsileto	提示，暗示
konsili	劝说，劝，相劝，劝告
konsilo	忠告
konsistigaĵo	成分
konsoli	安慰
konsonanta litero	辅音字母
konsonanto	辅音，子音
konstruaĵo	建筑物
konstrui	建设
konsumanto	消费者
kontakti	联系到，联络上
kontakto	联络，联系
kontanto	现金
kontenta	满意
kontentigi	满足
kontinento	大陆
konto	账户
kontrakto	合约
kontraŭ	对面，对着
kontraŭdira	自相矛盾
kontraŭdiro	矛盾
kontraŭe	对面
kontraŭi	反对
kontraŭstarema	顽固，固执
kontraŭstari	抵抗
kontraŭulo	对手
kontribui	贡献
kontroli	查看
konvena	合适
Konvencioj de Ĝenevo	日内瓦公约
konvinki	说服
kopii mane	抄写
kopirajto	版权
kopulo	系词
kora valvo	心瓣
korbato	心搏
korbeto	小篮子
korbo	篮子
korbopilko	篮球
kordo	绳子
kordoloro	心痛
korea skribo	韩文
Koreio	韩国
korekti	纠正
korelativa vorto	关联词
koridoro	走廊
korkokverkarbo	栓皮栎，软木橡树
korkokverko	栓皮栎，软木橡树
kornea	眼角膜
korniko	乌鸦，乌，鸦
kornusarbo	红瑞木，山茱萸树，山茱萸
kornuso	红瑞木，山茱萸，山茱萸树
koro	心脏，心
koronaria arterio	冠状动脉
korpa kavo	腔
korpharo	毛
korplingvo	肢体语言
korpo	身，身体
korpremita	忧郁
kortumo	法院，法庭
kosma spaco	太空
koŝmaro	魇，噩梦，恶梦，梦魇
koto	泥巴
kotonarbo	棉花，棉
kotono	棉花，棉布，棉
koverto	信封
kovrilo	盖子
krabo	蟹，螃蟹，螃
kraĉaĵo	痰
krajono	钱币
krajonpintigilo	削铅笔器
kranio	颅，头颅
kratagarbo	山楂，山查，查，楂
kratago	查，楂，山查，山楂
kravato	领带
kredi	信，相信
kreditkarto	信用卡
kredito	信用
kreema	创意
krei	创造
kremo	奶油
kreskado	成长
kriegi	尖叫
krimulo	犯人
kripla	残废
kriptono	氪
Kristandemokratoj	基督教民主党
kristano	基督教徒
kritiki	批评
krizantemfloro	菊花，菊
krizantemo	菊花，菊
krizo	危机
kroĉilo	钩子
krokodilo	鳄鱼，鳄
krom	除了…外，除了…以外，除，除了…之外，除外，除…外
krom se	除非
krome	再加上，而且，另
kromnomo	绰号
kromo	铬
Krono	克洛诺斯
krono	冕，冠冕
krucmilitistoj	十字军
krucmilitoj	十字军东征
kruela	残忍
kruro	小腿，胫
kruta	陡峭
ksenono	氙
ksifio	旗鱼
Kublaj Ĥano	忽必烈
kubuto	肘，手肘
kudrado	针线，针线活
kudraĵo	针线，针线活
kudrero	一针
kudri	缝纫，缝合
kudrilarkorbo	针线筐
kudrilarujo	针线盒
kudrilo	针
kudrilo kaj fadeno	针线
kudristino	女裁缝，针线工，做针线工的
kudrofadeno	缝纫线
kudromaŝino	缝衣机，缝纫机
kuglo	子弹
kuirejo	厨，厨房，出访
kuirforno	炉灶
kuiristo	厨师
kuko	蛋糕
kukolo	鹃，杜鹃
kulero	汤匙
kulo	蠓虫，小虫
kulpa	有罪
kulpigi	指控，怪，责怪
kulpigito	被告
kulpiko	小虫叮的包
kulturejo	农园
kulturkampo	农地
kulturo	文化
kun	跟
kundividi	分享
kune	一起
kuniga histo	结缔组织
kuniklo	兔，兔子
kunlabori	合作
kunmetita vorto	复词，复合词
Kunmingo	昆明
kuntiriĝi	收缩
kunvenigi	带来，使一道来
kunveno	会议
kupro	铜
kuracisto	医生
kuraĝa	勇敢
kuraĝi	胆敢
kuraĝigi	鼓励
kuraĝo	勇气
kuriero	象
kuriumo	锔
kurta cirkvito	短路
kurteno	窗廉
kuŝiĝi	躺下
kutima	平常
kutime	习惯了，通常，惯
kutimi	习惯，惯于
kutimo	风俗，习惯
kvadrata	正方形
kvadricepso	股四头肌，四头肌
kvalifiko	资格
kvalito	质，品质，质量
kvankam	虽然
kvar	四
kvar mil	四千
kvar miliardo	四十亿
kvar miliono	四百万
kvar minutoj	四分钟
kvara	第四
kvarcent	四百
kvarcent mil	四十万
kvarcent miliono	四亿
kvardek	四十
kvardek du	四十二
kvardek kvar	四十四
kvardek kvin	四十五
kvardek kvin minutoj	四十五分钟
kvardek mil	四万
kvardek miliono	四千万
kvardek minutoj	四十分钟
kvardek naŭ	四十九
kvardek ok	四十八
kvardek sep	四十七
kvardek ses	四十六
kvardek tri	四十三
kvardek unu	四十一
kvardeka	第四十
kvarfoje	四次
kvarkapa muskolo	四头肌，股四头肌
kvaroble	四倍
kvaronhoro	一刻
kvarono	四分之一
kvarsigna ĉina esprimo	成语
kvarsigna idiotismo	成语
kvazaŭ	就像，就如
kverkarbo	栎，橡，橡树
kverko	橡树，栎，橡
kvieta	安静
kvin	五
kvin mil	五千
kvin miliardo	五十亿
kvin miliono	五百万
kvin minutoj	五分钟
kvina	第五
kvincent	五百
kvincent mil	五十万
kvincent miliono	五亿
kvindek	五十
kvindek du	五十二
kvindek kvar	五十四
kvindek kvin	五十五
kvindek mil	五万
kvindek miliono	五千万
kvindek naŭ	五十九
kvindek ok	五十八
kvindek sep	五十七
kvindek ses	五十六
kvindek tri	五十三
kvindek unu	五十一
kvindeka	第五十
kvinfoje	五次
kvinoble	五倍
kvinono	五分之一
la afrikansa	南非语
la afrikansa lingvo	南非语
la Aksaj Potencoj	轴心国
la albana	阿尔巴尼亚语
la albana lingvo	阿尔巴尼亚语
la Aliancanoj	同盟国
la angla	英语，英文
la angla lingvo	英文，英语
la araba	阿拉伯语，阿拉伯文，阿拉伯话
la araba lingvo	阿拉伯语，阿拉伯话，阿拉伯文
la aŭtuna ekvinokso	秋分
la bengala	孟加拉语
la bengala lingvo	孟加拉语
la birma	缅甸语
la birma lingvo	缅甸语
la Blanka Domo	白宫
la bulgara	保加利亚语
la bulgara lingvo	保加利亚语
la ĉeftero de Ĉinio	大陆，中国大陆
la ĉeĥa	捷克语
la ĉeĥa lingvo	捷克语
la Ĉiela Altaro	天坛
la Ĉin-dinastio	秦
la ĉina	中文，中国话，汉语
la ĉina lingvo	华语，汉语，中文，中国话
la ĉina parolo	中国话
la Ĉina Popola Respubliko	中国人民共和国
la Ĉina revolucio de 1911	辛亥革命
la ĉina urbo Ĉongĉingo	重庆
la ĉina urbo Tjanĝino	天津
la Ĉing-dinastio	清
la ĉinula lingvo	华语
la dana	丹麦语
la dana lingvo	丹麦语
la dek dua de aprilo	四月十二日，四月十二号
la dek dua de aŭgusto	八月十二号，八月十二日
la dek dua de decembro	十二月十二号，十二月十二日
la dek dua de februaro	二月十二号，二月十二日
la dek dua de januaro	一月十二日，一月十二号
la dek dua de julio	七月十二日，七月十二号
la dek dua de junio	六月十二日，六月十二号
la dek dua de majo	五月十二号，五月十二日
la dek dua de marto	三月十二号，三月十二日
la dek dua de novembro	十一月十二号，十一月十二日
la dek dua de oktobro	十月十二号，十月十二日
la dek dua de septembro	九月十二号，九月十二日
la dek kvara de aprilo	四月十四日，四月十四号
la dek kvara de aŭgusto	八月十四日，八月十四号
la dek kvara de decembro	十二月十四号，十二月十四日
la dek kvara de februaro	二月十四号，二月十四日
la dek kvara de januaro	一月十四日，一月十四号
la dek kvara de julio	七月十四日，七月十四号
la dek kvara de junio	六月十四号，六月十四日
la dek kvara de majo	五月十四日，五月十四号
la dek kvara de marto	三月十四号，三月十四日
la dek kvara de novembro	十一月十四号，十一月十四日
la dek kvara de oktobro	十月十四日，十月十四号
la dek kvara de septembro	九月十四日，九月十四号
la dek kvina de aprilo	四月十五号，四月十五日
la dek kvina de aŭgusto	八月十五日，八月十五号
la dek kvina de decembro	十二月十五日，十二月十五号
la dek kvina de februaro	二月十五号，二月十五日
la dek kvina de januaro	一月十五日，一月十五号
la dek kvina de julio	七月十五日，七月十五号
la dek kvina de junio	六月十五日，六月十五号
la dek kvina de majo	五月十五日，五月十五号
la dek kvina de marto	三月十五日，三月十五号
la dek kvina de novembro	十一月十五号，十一月十五日
la dek kvina de oktobro	十月十五日，十月十五号
la dek kvina de septembro	九月十五号，九月十五日
la dek naŭa de aprilo	四月十九日，四月十九号
la dek naŭa de aŭgusto	八月十九日，八月十九号
la dek naŭa de decembro	十二月十九号，十二月十九日
la dek naŭa de februaro	二月十九日，二月十九号
la dek naŭa de januaro	一月十九日，一月十九号
la dek naŭa de julio	七月十九号，七月十九日
la dek naŭa de junio	六月十九号，六月十九日
la dek naŭa de majo	五月十九日，五月十九号
la dek naŭa de marto	三月十九号，三月十九日
la dek naŭa de novembro	十一月十九日，十一月十九号
la dek naŭa de oktobro	十月十九号，十月十九日
la dek naŭa de septembro	九月十九日，九月十九号
la dek oka de aprilo	四月十八日，四月十八号
la dek oka de aŭgusto	八月十八日，八月十八号
la dek oka de decembro	十二月十八号，十二月十八日
la dek oka de februaro	二月十八号，二月十八日
la dek oka de januaro	一月十八号，一月十八日
la dek oka de julio	七月十八日，七月十八号
la dek oka de junio	六月十八日，六月十八号
la dek oka de majo	五月十八号，五月十八日
la dek oka de marto	三月十八号，三月十八日
la dek oka de novembro	十一月十八号，十一月十八日
la dek oka de oktobro	十月十八日，十月十八号
la dek oka de septembro	九月十八号，九月十八日
la dek sepa de aprilo	四月十七号，四月十七日
la dek sepa de aŭgusto	八月十七日，八月十七号
la dek sepa de decembro	十二月十七号，十二月十七日
la dek sepa de februaro	二月十七号，二月十七日
la dek sepa de januaro	一月十七日，一月十七号
la dek sepa de julio	七月十七日，七月十七号
la dek sepa de junio	六月十七日，六月十七号
la dek sepa de majo	五月十七日，五月十七号
la dek sepa de marto	三月十七日，三月十七号
la dek sepa de novembro	十一月十七日，十一月十七号
la dek sepa de oktobro	十月十七日，十月十七号
la dek sepa de septembro	九月十七号，九月十七日
la dek sesa de aprilo	四月十六号，四月十六日
la dek sesa de aŭgusto	八月十六号，八月十六日
la dek sesa de decembro	十二月十六日，十二月十六号
la dek sesa de februaro	二月十六号，二月十六日
la dek sesa de januaro	一月十六号，一月十六日
la dek sesa de julio	七月十六日，七月十六号
la dek sesa de junio	六月十六日，六月十六号
la dek sesa de majo	五月十六号，五月十六日
la dek sesa de marto	三月十六号，三月十六日
la dek sesa de novembro	十一月十六日，十一月十六号
la dek sesa de oktobro	十月十六号，十月十六日
la dek sesa de septembro	九月十六号，九月十六日
la dek tria de aprilo	四月十三号，四月十三日
la dek tria de aŭgusto	八月十三日，八月十三号
la dek tria de decembro	十二月十三号，十二月十三日
la dek tria de februaro	二月十三日，二月十三号
la dek tria de januaro	一月十三号，一月十三日
la dek tria de julio	七月十三日，七月十三号
la dek tria de junio	六月十三日，六月十三号
la dek tria de majo	五月十三日，五月十三号
la dek tria de marto	三月十三日，三月十三号
la dek tria de novembro	十一月十三号，十一月十三日
la dek tria de oktobro	十月十三号，十月十三日
la dek tria de septembro	九月十三号，九月十三日
la dek unua de aprilo	四月十一号，四月十一日
la dek unua de aŭgusto	八月十一号，八月十一日
la dek unua de decembro	十二月十一号，十二月十一日
la dek unua de februaro	二月十一号，二月十一日
la dek unua de januaro	一月十一日，一月十一号
la dek unua de julio	七月十一日，七月十一号
la dek unua de junio	六月十一号，六月十一日
la dek unua de majo	五月十一日，五月十一号
la dek unua de marto	三月十一日，三月十一号
la dek unua de novembro	十一月十一号，十一月十一日
la dek unua de oktobro	十月十一号，十月十一日
la dek unua de septembro	九月十一号，九月十一日
la dek-dua horo	十二点，十二点钟
la dek-unua horo	十一点钟，十一点
la deka de aprilo	四月十号，四月十日
la deka de aŭgusto	八月十日，八月十号
la deka de decembro	十二月十号，十二月十日
la deka de februaro	二月十号，二月十日
la deka de januaro	一月十日，一月十号
la deka de julio	七月十日，七月十号
la deka de junio	六月十号，六月十日
la deka de majo	五月十日，五月十号
la deka de marto	三月十号，三月十日
la deka de novembro	十一月十号，十一月十日
la deka de oktobro	十月十号，十月十日
la deka de septembro	九月十号，九月十日
la deka horo	十点钟，十点
la destino	命
la dua de aprilo	四月二号，四月二日
la dua de aŭgusto	八月二日，八月二号
la dua de decembro	十二月二号，十二月二日
la dua de februaro	二月二号，二月二日
la dua de januaro	一月二日，一月二号
la dua de julio	七月二号，七月二日
la dua de junio	六月二日，六月二号
la dua de majo	五月二号，五月二日
la dua de marto	三月二日，三月二号
la dua de novembro	十一月二日，十一月二号
la dua de oktobro	十月二日，十月二号
la dua de septembro	九月二号，九月二日
la dua horo	两点，两点钟
la dua mondmilito	第二次大战，二战，第二次世界大战
la dudek dua de aprilo	四月二十二日，四月二十二号
la dudek dua de aŭgusto	八月二十二日，八月二十二号
la dudek dua de decembro	十二月二十二号，十二月二十二日
la dudek dua de februaro	二月二十二号，二月二十二日
la dudek dua de januaro	一月二十二号，一月二十二日
la dudek dua de julio	七月二十二日，七月二十二号
la dudek dua de junio	六月二十二号，六月二十二日
la dudek dua de majo	五月二十二日，五月二十二号
la dudek dua de marto	三月二十二日，三月二十二号
la dudek dua de novembro	十一月二十二号，十一月二十二日
la dudek dua de oktobro	十月二十二日，十月二十二号
la dudek dua de septembro	九月二十二日，九月二十二号
la dudek kvara de aprilo	四月二十四日，四月二十四号
la dudek kvara de aŭgusto	八月二十四日，八月二十四号
la dudek kvara de decembro	十二月二十四日，十二月二十四号
la dudek kvara de februaro	二月二十四号，二月二十四日
la dudek kvara de januaro	一月二十四日，一月二十四号
la dudek kvara de julio	七月二十四日，七月二十四号
la dudek kvara de junio	六月二十四号，六月二十四日
la dudek kvara de majo	五月二十四号，五月二十四日
la dudek kvara de marto	三月二十四日，三月二十四号
la dudek kvara de novembro	十一月二十四号，十一月二十四日
la dudek kvara de oktobro	十月二十四号，十月二十四日
la dudek kvara de septembro	九月二十四日，九月二十四号
la dudek kvina de aprilo	四月二十五日，四月二十五号
la dudek kvina de aŭgusto	八月二十五日，八月二十五号
la dudek kvina de decembro	十二月二十五日，十二月二十五号
la dudek kvina de februaro	二月二十五日，二月二十五号
la dudek kvina de januaro	一月二十五日，一月二十五号
la dudek kvina de julio	七月二十五日，七月二十五号
la dudek kvina de junio	六月二十五日，六月二十五号
la dudek kvina de majo	五月二十五日，五月二十五号
la dudek kvina de marto	三月二十五号，三月二十五日
la dudek kvina de novembro	十一月二十五号，十一月二十五日
la dudek kvina de oktobro	十月二十五日，十月二十五号
la dudek kvina de septembro	九月二十五日，九月二十五号
la dudek naŭa de aprilo	四月二十九号，四月二十九日
la dudek naŭa de aŭgusto	八月二十九号，八月二十九日
la dudek naŭa de decembro	十二月二十九号，十二月二十九日
la dudek naŭa de februaro	二月二十九日，二月二十九号
la dudek naŭa de januaro	一月二十九日，一月二十九号
la dudek naŭa de julio	七月二十九日，七月二十九号
la dudek naŭa de junio	六月二十九日，六月二十九号
la dudek naŭa de majo	五月二十九号，五月二十九日
la dudek naŭa de marto	三月二十九号，三月二十九日
la dudek naŭa de novembro	十一月二十九号，十一月二十九日
la dudek naŭa de oktobro	十月二十九日，十月二十九号
la dudek naŭa de septembro	九月二十九号，九月二十九日
la dudek oka de aprilo	四月二十八日，四月二十八号
la dudek oka de aŭgusto	八月二十八号，八月二十八日
la dudek oka de decembro	十二月二十八号，十二月二十八日
la dudek oka de februaro	二月二十八号，二月二十八日
la dudek oka de januaro	一月二十八日，一月二十八号
la dudek oka de julio	七月二十八号，七月二十八日
la dudek oka de junio	六月二十八号，六月二十八日
la dudek oka de majo	五月二十八号，五月二十八日
la dudek oka de marto	三月二十八日，三月二十八号
la dudek oka de novembro	十一月二十八日，十一月二十八号
la dudek oka de oktobro	十月二十八号，十月二十八日
la dudek oka de septembro	九月二十八号，九月二十八日
la dudek sepa de aprilo	四月二十七号，四月二十七日
la dudek sepa de aŭgusto	八月二十七号，八月二十七日
la dudek sepa de decembro	十二月二十七日，十二月二十七号
la dudek sepa de februaro	二月二十七号，二月二十七日
la dudek sepa de januaro	一月二十七号，一月二十七日
la dudek sepa de julio	七月二十七日，七月二十七号
la dudek sepa de junio	六月二十七号，六月二十七日
la dudek sepa de majo	五月二十七日，五月二十七号
la dudek sepa de marto	三月二十七号，三月二十七日
la dudek sepa de novembro	十一月二十七号，十一月二十七日
la dudek sepa de oktobro	十月二十七日，十月二十七号
la dudek sepa de septembro	九月二十七日，九月二十七号
la dudek sesa de aprilo	四月二十六号，四月二十六日
la dudek sesa de aŭgusto	八月二十六日，八月二十六号
la dudek sesa de decembro	十二月二十六日，十二月二十六号
la dudek sesa de februaro	二月二十六号，二月二十六日
la dudek sesa de januaro	一月二十六号，一月二十六日
la dudek sesa de julio	七月二十六日，七月二十六号
la dudek sesa de junio	六月二十六号，六月二十六日
la dudek sesa de majo	五月二十六号，五月二十六日
la dudek sesa de marto	三月二十六号，三月二十六日
la dudek sesa de novembro	十一月二十六日，十一月二十六号
la dudek sesa de oktobro	十月二十六号，十月二十六日
la dudek sesa de septembro	九月二十六号，九月二十六日
la dudek tria de aprilo	四月二十三日，四月二十三号
la dudek tria de aŭgusto	八月二十三日，八月二十三号
la dudek tria de decembro	十二月二十三日，十二月二十三号
la dudek tria de februaro	二月二十三号，二月二十三日
la dudek tria de januaro	一月二十三号，一月二十三日
la dudek tria de julio	七月二十三号，七月二十三日
la dudek tria de junio	六月二十三日，六月二十三号
la dudek tria de majo	五月二十三日，五月二十三号
la dudek tria de marto	三月二十三日，三月二十三号
la dudek tria de novembro	十一月二十三日，十一月二十三号
la dudek tria de oktobro	十月二十三号，十月二十三日
la dudek tria de septembro	九月二十三日，九月二十三号
la dudek unua de aprilo	四月二十一日，四月二十一号
la dudek unua de aŭgusto	八月二十一日，八月二十一号
la dudek unua de decembro	十二月二十一日，十二月二十一号
la dudek unua de februaro	二月二十一日，二月二十一号
la dudek unua de januaro	一月二十一号，一月二十一日
la dudek unua de julio	七月二十一号，七月二十一日
la dudek unua de junio	六月二十一日，六月二十一号
la dudek unua de majo	五月二十一号，五月二十一日
la dudek unua de marto	三月二十一号，三月二十一日
la dudek unua de novembro	十一月二十一号，十一月二十一日
la dudek unua de oktobro	十月二十一号，十月二十一日
la dudek unua de septembro	九月二十一号，九月二十一日
la dudeka de aprilo	四月二十号，四月二十日
la dudeka de aŭgusto	八月二十日，八月二十号
la dudeka de decembro	十二月二十号，十二月二十日
la dudeka de februaro	二月二十号，二月二十日
la dudeka de januaro	一月二十号，一月二十日
la dudeka de julio	七月二十日，七月二十号
la dudeka de junio	六月二十号，六月二十日
la dudeka de majo	五月二十号，五月二十日
la dudeka de marto	三月二十号，三月二十日
la dudeka de novembro	十一月二十号，十一月二十日
la dudeka de oktobro	十月二十号，十月二十日
la dudeka de septembro	九月二十号，九月二十日
la duoblo de	一倍
la epoko de Klerismo	启蒙时代
la estona	爱沙尼亚语
la estona lingvo	爱沙尼亚语
la eŭska	巴斯克语
la eŭska lingvo	巴斯克语
la fandujo granda	大熔炉
la filipina	菲律宾话，菲律宾语
la filipina lingvo	菲律宾语，菲律宾话
la finna	芬兰语
la finna lingvo	芬兰语
la Flava Rivero	黄河，河
la franca	法文，法语
la franca lingvo	法语，法文
la gaela	盖尔语
la gaela lingvo	盖尔语
la gardisto	士，仕
la Ĝenerala Asembleo de UN	联合国大会
la generalo	将，帅
la germana	德文，德语
la germana lingvo	德文，德语
la Ĝin-dinastio	金，晋
la Ĝoŭ-dinastio	周
la Granda Muro	万里长城，长城
la greka	希腊文，希腊语，希腊话
la greka lingvo	希腊语，希腊文，希腊话
la Han-dinastio	汉
la hanĉina lingvo	汉语
la hebrea	希伯来话，希伯来语，希伯来文
la hebrea lingvo	希伯来文，希伯来语，希伯来话
la Heĝiro	回教纪元
la hindia	印地语，印度话
la hindia lingvo	印地语，印度话
la hispana	西班牙文，西班牙语
la hispana lingvo	西班牙语，西班牙文
la hungara	匈牙利语
la hungara lingvo	匈牙利语
la indonezia	印尼语，印尼文
la indonezia lingvo	印尼文，印尼语
la insulo Hajnano	海南岛
la insulo Tajvano	台湾
la Internacia Kortumo de Justeco	国际法庭，国际法院
la Interreto	因特网
la irlanda	爱尔兰语
la irlanda lingvo	爱尔兰语
la Islama kalendaro	回历
la islanda	冰岛语
la islanda lingvo	冰岛语
la itala	意大利语
la itala lingvo	意大利语
la Jangzio-rivero	江，长江
la japana	日本话，日语，日文
la japana lingvo	日语，日本话，日文
la jida	意第绪语
la jida lingvo	意第绪语
la Jŭan-dinastio	元
la kantona	广东话
la kantona lingvo	广东话，粤语，广州话
la kimra	威尔士语
la kimra lingvo	威尔士语
la klasika ĉina	文言文
la klasika ĉina lingvo	文言文
la Komuna Erao	公元
la komuna parolo	普通话
la Komunista Partio de Ĉinio	党，中共，中国共产党
la Korano	古兰经
la korea	韩国语，朝鲜文，韩语，韩文，朝语，朝鲜语，韩国话，朝鲜话
la korea lingvo	朝鲜话，韩语，朝语，韩国语，韩国话，朝鲜文，朝鲜语，韩文
la kroata	克罗地亚语
la kroata lingvo	克罗地亚语
la kvara de aprilo	四月四号，四月四日
la kvara de aŭgusto	八月四日，八月四号
la kvara de decembro	十二月四日，十二月四号
la kvara de februaro	二月四号，二月四日
la kvara de januaro	一月四号，一月四日
la kvara de julio	七月四号，七月四日
la kvara de junio	六月四日，六月四号
la kvara de majo	五月四日，五月四号
la kvara de marto	三月四号，三月四日
la kvara de novembro	十一月四日，十一月四号
la kvara de oktobro	十月四日，十月四号
la kvara de septembro	九月四日，九月四号
la kvara horo	四点，四点钟
la kvina de aprilo	四月五日，四月五号
la kvina de aŭgusto	八月五日，八月五号
la kvina de decembro	十二月五日，十二月五号
la kvina de februaro	二月五号，二月五日
la kvina de januaro	一月五号，一月五日
la kvina de julio	七月五号，七月五日
la kvina de junio	六月五号，六月五日
la kvina de majo	五月五号，五月五日
la kvina de marto	三月五日，三月五号
la kvina de novembro	十一月五日，十一月五号
la kvina de oktobro	十月五号，十月五日
la kvina de septembro	九月五号，九月五日
la kvina horo	五点，五点钟
la laosa	老挝语，寮语
la laosa lingvo	寮语，老挝语
la latina lingvo	拉丁文
la latva	拉脱维亚语
la latva lingvo	拉脱维亚语
la litova	立陶宛语
la litova lingvo	立陶宛语
la Ljaŭ-dinastio	遼
la makedona	马其顿语
la makedona lingvo	马其顿语
la malagasa	马达加斯加语
la malagasa lingvo	马达加斯加语
la malaja	马来文，马来语
la malaja lingvo	马来语，马来文
la Malvarma milito	冷战
la maoria	毛利语
la maoria lingvo	毛利语
la Meza Regno	中国
La Mezepoko	中世纪
la mia	我的
la Ming-dinastio	明
la mongola	蒙古话，蒙古语，蒙古文
la mongola lingvo	蒙古语，蒙古文，蒙古话
la nacia lingvo	国语
la nagaria skribo	天城文
la naŭa de aprilo	四月九日，四月九号
la naŭa de aŭgusto	八月九日，八月九号
la naŭa de decembro	十二月九号，十二月九日
la naŭa de februaro	二月九号，二月九日
la naŭa de januaro	一月九日，一月九号
la naŭa de julio	七月九日，七月九号
la naŭa de junio	六月九日，六月九号
la naŭa de majo	五月九号，五月九日
la naŭa de marto	三月九号，三月九日
la naŭa de novembro	十一月九号，十一月九日
la naŭa de oktobro	十月九号，十月九日
la naŭa de septembro	九月九日，九月九号
la naŭa horo	九点，九点钟
la nederlanda	荷兰文，荷兰语
la nederlanda lingvo	荷兰语，荷兰文
la nepala	尼泊尔语
la nepala lingvo	尼泊尔语
la nia	我们的
la Nobelpremio	诺贝尔奖
la Nobelpremio por literaturo	诺贝尔文学奖
la norvega	挪威语
la norvega lingvo	挪威语
la oficista lingvo	官话
la oka de aprilo	四月八日，四月八号
la oka de aŭgusto	八月八日，八月八号
la oka de decembro	十二月八号，十二月八日
la oka de februaro	二月八号，二月八日
la oka de januaro	一月八号，一月八日
la oka de julio	七月八号，七月八日
la oka de junio	六月八日，六月八号
la oka de majo	五月八号，五月八日
la oka de marto	三月八日，三月八号
la oka de novembro	十一月八号，十一月八日
la oka de oktobro	十月八日，十月八号
la oka de septembro	九月八日，九月八号
la oka horo	八点，八点钟
la olimpia flago	奥运会会旗
la Olimpiaj ludoj	奥林匹克运动会，奥运会，奥运
la Pakto Ribbentrop-Molotov	苏德互不侵犯条约
la palia lingvo	巴利语
la pekina parolo	北京话
la perioda tabelo de la elementoj	元素周期表
la persa	波斯文，波斯语
la persa lingvo	波斯语，波斯文
la plejparto	大部分，大多数
la plejparto de	大部分的，一般的
la pola	波兰语
la pola lingvo	波兰语
la portugala	葡萄牙语，葡萄牙文
la portugala lingvo	葡萄牙文，葡萄牙语
la printempa ekvinokso	春分
la Renesanco	文艺复兴
la Respubliko de Ĉinio	中华民国
la Reto	因特网
la romano "Pilgrimo al la Okcidento"	西游记
la rumana	罗马尼亚语
la rumana lingvo	罗马尼亚语
la rusa	俄语，俄罗斯语，俄文
la rusa lingvo	俄语，俄罗斯语，俄文
la Ŝang-dinastio	商
la sanskrita lingvo	梵语，梵文
la Sekureca Konsilio de UN	联合国安全理事会，联合国安理会，安理会
la sepa de aprilo	四月七日，四月七号
la sepa de aŭgusto	八月七日，八月七号
la sepa de decembro	十二月七日，十二月七号
la sepa de februaro	二月七号，二月七日
la sepa de januaro	一月七日，一月七号
la sepa de julio	七月七号，七月七日
la sepa de junio	六月七号，六月七日
la sepa de majo	五月七号，五月七日
la sepa de marto	三月七日，三月七号
la sepa de novembro	十一月七号，十一月七日
la sepa de oktobro	十月七日，十月七号
la sepa de septembro	九月七号，九月七日
la sepa horo	七点钟，七点
la serba	塞尔维亚语
la serba lingvo	塞尔维亚语
la sesa de aprilo	四月六日，四月六号
la sesa de aŭgusto	八月六日，八月六号
la sesa de decembro	十二月六号，十二月六日
la sesa de februaro	二月六号，二月六日
la sesa de januaro	一月六号，一月六日
la sesa de julio	七月六日，七月六号
la sesa de junio	六月六日，六月六号
la sesa de majo	五月六日，五月六号
la sesa de marto	三月六号，三月六日
la sesa de novembro	十一月六号，十一月六日
la sesa de oktobro	十月六日，十月六号
la sesa de septembro	九月六号，九月六日
la sesa horo	六点，六点钟
la Sinhaja revolucio	辛亥革命
la Ŝja-dinastio	夏
la slovaka	斯洛伐克语
la slovaka lingvo	斯洛伐克语
la Somera Palaco	颐和园
la Song-dinastio	宋
la Ŝu-Reĝlando	蜀
la Suej-dinastio	隋
la sumera solstico	夏至
la svahila	斯瓦希里语
la svahila lingvo	斯瓦希里语
la sveda	瑞典语
la sveda lingvo	瑞典语
la taja	泰国语，泰文，泰语
la taja lingvo	泰国语，泰文，泰语
la tamila	泰米尔语
la tamila lingvo	泰米尔语
la Tang-dinastio	唐
la Terakota Legio de Qin-dinastio	兵马俑
la tibeta	藏语，藏文
la tibeta lingvo	藏语，藏文
la Titanoj	提坦巨神，泰坦
la Tri Gorĝoj	三峡
la Tri Gorĝoj de Jangzio-Rivero	三峡
la tria de aprilo	四月三日，四月三号
la tria de aŭgusto	八月三日，八月三号
la tria de decembro	十二月三日，十二月三号
la tria de februaro	二月三号，二月三日
la tria de januaro	一月三号，一月三日
la tria de julio	七月三日，七月三号
la tria de junio	六月三日，六月三号
la tria de majo	五月三号，五月三日
la tria de marto	三月三号，三月三日
la tria de novembro	十一月三日，十一月三号
la tria de oktobro	十月三号，十月三日
la tria de septembro	九月三日，九月三号
la tria horo	三点钟，三点
la tridek unua de aŭgusto	八月三十一号，八月三十一日
la tridek unua de decembro	十二月三十一日，十二月三十一号
la tridek unua de januaro	一月三十一日，一月三十一号
la tridek unua de julio	七月三十一日，七月三十一号
la tridek unua de majo	五月三十一日，五月三十一号
la tridek unua de marto	三月三十一日，三月三十一号
la tridek unua de oktobro	十月三十一号，十月三十一日
la trideka de aprilo	四月三十日，四月三十号
la trideka de aŭgusto	八月三十日，八月三十号
la trideka de decembro	十二月三十日，十二月三十号
la trideka de januaro	一月三十日，一月三十号
la trideka de julio	七月三十号，七月三十日
la trideka de junio	六月三十号，六月三十日
la trideka de majo	五月三十日，五月三十号
la trideka de marto	三月三十号，三月三十日
la trideka de novembro	十一月三十号，十一月三十日
la trideka de oktobro	十月三十日，十月三十号
la trideka de septembro	九月三十日，九月三十号
la turka	土耳其文，土耳其语
la turka lingvo	土耳其语，土耳其文
la tuta	整个，整
la Ŭej-Reĝlando	魏
la ukraina	乌克兰语
la ukraina lingvo	乌克兰语
la Universala Deklaracio de Homaj Rajtoj	世界人权宣言
la unua de aprilo	四月一日，四月一号
la unua de aŭgusto	八月一号，八月一日
la unua de decembro	十二月一日，十二月一号
la unua de februaro	二月一日，二月一号
la unua de januaro	一月一号，一月一日
la unua de julio	七月一日，七月一号
la unua de junio	六月一号，六月一日
la unua de majo	五月一日，五月一号
la unua de marto	三月一号，三月一日
la unua de novembro	十一月一号，十一月一日
la unua de oktobro	十月一号，十月一日
la unua de septembro	九月一日，九月一号
la unua horo	一点，一点钟
La Unua Imperiestro de la Dinastio Qin	秦始皇
la unua mondmilito	第一次大战，第一次世界大战，一战
la urdua lingvo	乌尔都语
la Ŭu-Reĝlando	吳
La Verdaj	欧洲绿党
la via	你们的，你的
la vintra solstico	冬至
la vjetnama	越南语，越南话，越南文
la vjetnama lingvo	越南文，越南语，越南话
la zulua	祖鲁语
la zulua lingvo	祖鲁语
laboranto	工人
laboratorio	实验室
laborejo	工作场所
labori	打工，工作
laboro	工，工作，劳动
laburnfloro	金链花
laburno	金链花
laca	累
lacerto	蜥，蜴，蜥蜴
ladskatolo	罐头
lageto	水池，池塘
Lakta vojo	银河系
laktodento	乳齿
laminario	藻，海藻
lampo	电灯，灯
lanco	长枪
landlimo	边境
lando	国家，国
lango	舌，舌头
Lanĝoŭo	兰州
lano	羊毛
lantano	镧 
lapo	牛蒡子，牛蒡，大力子，蒡
larĝa	广，宽
larikarbo	落叶松，落叶松树
lariko	落叶松，落叶松树
laringo	喉头，喉
larmi	流眼泪，流泪
larmo	泪，眼泪，泪水
Lasao	拉萨
lasera presilo	激光打印机
lasero	激光
lasi	让
lastatempe	近来，最近
Latino	拉丁文
laŭ	照，据，按照，按
laŭ mia scio	据我所知
laŭdi	赞美
laŭdire	所谓
laŭleĝa	合法
laŭrarbo	月桂树
laŭrencio	铹
laŭro	月桂树
laŭtparolilo	喇叭
laŭvorta	字面
lavejo	洗手间
lavendfloro	薰衣草
lavendo	薰衣草
leciono	课
ledo	皮，皮革，革
leganto	读者
legendo	传奇
legi	读，看书，读书
leĝo	法律，法
lekantfloro	雏菊，雏菊花
lekanto	雏菊，雏菊花
lemno	萍，浮萍
leonfaŭkfloro	龙嘴花
leonfaŭko	龙嘴花，金鱼草
leono	狮子，狮
leontodfloro	蒲公英花，蒲公英
leontodo	蒲公英花，蒲公英
leopardo	花豹
lernantaro	班
lernanto	学生
lernejestro	校长
lernejo	学校
lerni	学习
lernolibro	课本
lerta	聪明
lerteco	技巧
leterkesto	信箱
letero	信
leterportisto	邮差
leviĝi	起来，上升
li	他
li mem	他自己
lia	他的
lia propra	他自己的
libelo	蚂螂，蜓，蜻蜓，蚂，蜻
libera	有空
Libera Eŭropa Alianco	欧洲自由阵线联盟
liberala	开放
libereco	自由
liberigi	释放
libro	书，书本，一本書
librovendejo	书店
liĉiarbo	荔，荔枝树
lieno	脾脏，脾
lifto	电梯
ligamento	韧带
lignero	碎片，木刺
ligno	木材，木头
lignokarbo	木炭
Lignostelo	木星
Ligo de Arabaj Ŝtatoj	阿拉伯联盟，阿拉伯国家联盟，阿盟
Ligo de Nacioj	国际联盟，国联
likeno	地衣
likvaĵo	液体
likvigi	液化
likvo	液体
lilifloro	百合，百合花
lilio	百合，百合花
limako	鼻涕虫
limearbo	莱姆树
limfa glando	淋巴腺
limfo	淋巴
limfonodo	淋巴结
limigi	限制
limigita	有限
lin	他
lingvistiko	语言学
lingvo	语言，文，语
linko	猞，猁，猞猁
lino	亚麻
lipharo	胡子
lipo	嘴唇
listigi	列出
listo	名单
listo de kantoj	曲目
lita superkovrilo	被单，床罩
litaĵo	被褥，铺盖
lite	在床上
literaturo	文学
litero	字母
literumi	拼字
litio	锂
litkadro	床架
litkovrilo	被子，毛毯
litkuseno	枕头
litmalsana	卧床不起
lito	床，床铺
littuko	床单
litvagono	卧铺车，卧车
livio	鸽，鸽子
Ljaŭ-dinastio	辽
Ljaŭningo	辽，辽宁
loĝantaro	人口
loĝanto	居民
loĝejo	住宅
loĝi	居住
loĝi ĉe 	住在
logiko	逻辑
lokativa kazo	地格
lokativo	地格
loko	地方，场所
lokusto	蜢，蚱，蚱蜢
loligo	乌贼
longa	长
longa fingro	中指
longatempe	久，好久，很久，久久
longdaŭra	长期
longdistanca	长途
longeco	长度，长短
longtempa	长期
longtempe	久，好久，很久，久久
lonicero	忍冬
loterio	彩券
lotusfloro	荷花，芙蓉，芙蓉花，蓉，芙，莲，荷，莲花
lotuso	芙，荷花，荷，莲花，芙蓉花，蓉，莲，芙蓉
luanto	房客
ludi	玩，扮演，玩游戏
ludi tabulludon	对弈
ludilo	玩具
ludo	游戏
luebla	出租
lui	租用
lui de	租用
luigi	租出
lukontrakto	租约
lukti	挣扎
luktosporto	武术
lulilo	摇篮
lulkanto	摇篮曲
lum-ampolo	电灯泡
luma	明亮
lumdisko	光碟，光盘
lumjaro	光年
lumo	光
lumrapido	光速
lumturo	灯塔
lundo	一，礼拜一，星期一，周一
luno	月亮，月
Luno	月球
lupago	租金
lupo	狼
lutecio	镥，镏
lutro	獭，水獭
luzerno	紫花苜蓿，紫苜蓿
magazeno	百货公司
magio	魔法
magneta disko	磁盘
magneta kampo	磁场
magneto	磁铁
magnetofono	录音机
magnetoskopo	录影机
magnezio	镁
magnolifloro	玉兰，玉兰花
magnolio	玉兰花，玉兰
mahagono	桃花心木
maizo	玉米
majo	五月
Makao	澳，澳门
makropo	袋鼠
makzelo	颚，颌
malakra	迟钝
malalta	矮小，低
malaltmaro	低潮
malalttajdo	低潮
malami	仇恨，憎恨，讨厌
malamika	敌对的，敌意的
malamikeco	敌意
malamiko	仇人，敌人
malaminda	恶意的，恶毒的
malamo	仇恨，憎恨，怨恨
malantaŭ	后，以后，之后，后面
malantaŭe	在后面，往后
malantaŭplano	背景
malaperi	不见，不见了
malaperis	不见了
malavara	慷慨
malbela	丑陋，丑
malbona	坏，孬
malbona humoro	孬脾气
malbona kutimo	坏习惯
malbonega	邪恶
malbono	邪恶
malbonŝanco	孬运
malbonulo	坏人
malbonvola	勉强
maldika	薄，细
maldika intesto	小肠
maldorma	醒，清醒
maldormi	醒着
maldungi	炒鱿鱼，解雇
maldungita	失业
male	反而
malebligi	阻止，妨碍
malebria	清醒，醒
malebriiĝi	醒
malekvilibro	失衡
maleolo	踝，脚脖子，脚踝
malespera	绝望
malfacila	困难，难
malfeliĉa	伤心
malfeliĉego	灾难
malfermi	张开，开，打开
malfermi la pordon	开门
malfluido	固体
malfluso	退潮
malforta	弱，软弱
malfrua	晚，迟
malfruiĝi	来晚，迟到
malfruigi	误，耽搁
malfruiĝis	来晚了
malgaja	伤心，难过
malĝentila	不客气
malglata	粗糙
malĝoja	伤心
malgranda	小
malgranda fingro	小指
malgranda grupo	小组
malgrasa	瘦
malgraŭ	尽管，即使
malgraŭ tio	尽管如此，无论如何，不管怎样
malĝusta	不对，错
malhavi	缺少
malhelpi	帮倒忙
malica	邪恶
malico	邪恶
maljuna	老
maljusta	不公平
malklara	模糊
malkovri	发现
mallaborema	懒惰
mallarĝa	狭窄，窄
mallerta	笨拙
malleviĝi	下降
malliberejo	牢狱，监狱，狱，牢，监牢
mallonga	短
mallongigo	缩写
malluma	黑暗
malluma materio	暗物质
malmodesta	傲慢
malmola	硬
malmulta	少
malmultekosta	便宜
malneto	草稿
malnova	老旧，旧
malofta	不频发的，不常见的，稀少的，罕见的
malofte	很少有，不经常
malokupata	有空
maloportuna	不方便
malpacienca	不耐烦
malpermanenta	暂时
malpermesi	禁止
malpeza	轻
malpeza akvo	轻水
malpeza industrio	轻工业
malplena	空
malpli	少一点
malpliigi	减少
malpreciza	模糊
malprofunda	浅
malproksima	远
malpura	肮脏
malpurigo	污染
malrapida	迟，慢
malrapide	慢慢
malrapidtrajno	慢车
malrapidvagonaro	慢车
malreala	假
malrekta	间接
malriĉa	贫穷
malŝalti lampon	关灯，关电灯
malsama	不同，不一样
malsamo	差别
malsana	病
malsaniĝi	生病
malsano	疾，疾病，病
malsanulejo	医院
malsanulo	病人
malŝarĝi	卸载，卸下
malsata	肚子饿
malsatega	饥饿
malsatego	饥荒
malscio	无知
malseka	湿
malseketaĵo	水分
malsimpla	复杂
malŝlosi	开锁，开启
malŝminki	卸妆
malsovaĝa	温驯
malŝpari	浪费
malŝpari la tempon	浪费时间
malŝpari tempon	浪费时间
malŝparita	白费的，浪费的
malŝparo	浪费
malstreĉi	放宽
malstreĉiĝa	轻松，松
malstreĉiĝi	放轻松，放松
malstreĉita	松，轻松
malstrikta	松
malsukcesi	失败
malsupre	下面，楼下
malsuprensalti	跳下
maltrafi	错过
maltrankvila	紧张，担心
malvarma	冷，寒冷
malvarmega	寒冷
malvarmumo	感冒
malvenko	挫败，失败，败北
mambesto	哺乳动物，哺乳动物
mamo	乳，奶，乳房
mandarena	国语，官话，华语，北京话，普通话
mandiblo	颌骨，下颌，下颚，颌，颚骨，颚
mandragoro	曼陀罗草
manĝaĵo	食物
mangano	锰
mangarbo	芒果树
manĝfingro	食指
manĝi	吃
manĝo	饭
manĝokarto	菜单
mangrovo	红树林，红树
maniero	方式，方法
maniso	穿山甲
mankateno	手铐，铐
manki	欠缺，缺少
manksako	手提袋
manlaboro	劳动
manlibro	手册
mano	手
manplato	掌，手掌
manpremi	握手
manpremo	握手
mansaketo	手提袋
manto	螳螂，螳
mantuko	毛巾，手巾
maorio	毛利人
mar erinaco	海胆
mar-lutro	海獭
mararmeo	海军
marbordo	海边，海岸
mardo	星期二，礼拜二，二，周二
marfundo	海底
marioneto	木偶
maristo	水手
marleono	海狮
maro	海洋
marondo	海浪
Marso	火星，玛尔斯
Marso I	火卫一
marstelo	海星
martelo	铁锤
martestudo	海龟
marto	三月
masaĝi	按摩
maŝino	机器
maso	质量
masonisto	石匠
mastro	主人，主
matematiko	数学
matenmanĝi	吃早餐
matenmanĝo	早餐，噪音
mateno	早上，上午
materio	物质
matraco	床垫
matura	成熟，熟
meblaro	家具
mebloj	家具
meduzo	水母
mefito	臭鼬鼠
Mekao	麦加
meleagro	火鸡
melo	狗獾，貛
melodio	旋律，调子
membro	肢
membro de la korpo	肢
membroj	四肢
membroj de la korpo	四肢
memfida	有信心，有自信
memoraĵo	纪念品
memori	记住，记得，记
memorigi	提醒，纪念
memoro	记忆
mencii	提到，提
mendelevio	钔
menso	心，头脑，思想
mensogi	撒谎，说大话，骗人，说谎
mensogi al	骗
mensogisto	骗子
mensogo	大话，谎言，谎，谎话
mensogulo	骗子
mentono	下巴
menuo	菜单
merkato	市场，市
merkredo	礼拜三，三，星期三，周三
Merkuro	默丘利，水星
mesaĝo	讯息
metaforo	比喻，隐喻
metalo	金属
meteorito	陨石
meteoro	流星
meteoroido	流星体
meteorpluvo	流星雨
meti	放
metodo	方法
metroo	地下铁
mevo	海鸥
meza	中
mezaĝa	中年
mezaĝa viro	中年男子
mezfingro	中指
meznombra	平均
meztagmanĝi	吃午饭
meztagmanĝo	午饭
mi	我
mi bedaŭras	不好意思，抱歉
mi mem	我自己
mi tre bedaŭras	真不好意思，很抱歉
mia	我的…
mia propra	我自己的
mielmonato	蜜月
mieno	表情
migdalkukaĵo	杏仁饼，杏仁酥
migdalo	杏仁
migdalokula	有杏仁眼
migri	移民
mikroskopo	显微镜
mil	千，一千
miliardo	一十亿，十亿
miliono	一百万，百万
militĉaro	车
militistaro	陆军
militkrimulo	战犯
militmalliberulo	战俘
milito	战争，战
miloble	千倍
milono	千分之一
mimozfloro	含羞草
mimozo	含羞草
min	我
minaci	威胁
minaco	恐吓
Minerva	密涅瓦
Ming-dinastio	明朝
ministro	相
mino	地雷
Minotaŭro	米诺陶
minuto	分钟，分
miraklo	奇迹
miriga	令人吃惊
mirinda	精彩
miskompreni	误解
miskompreno	误会
mistera	神秘
misuzi	滥用
mitaro	神话
mito	神话
mitokondrio	线粒体，粒线体
mitologio	神话
modelo	模式
moderna	现代
modesta	谦虚
modo	语气
moki	嘲笑，笑
mola	软
mola histo	软组织
molaro	臼齿
molekula maso	分子量
molekulo	分子
molibdeno	钼
momente	一回儿
momento	时刻
monato	月
monbileto	钞票
monbiletujo	皮夹
Monda Banko	世界银行，国际复兴开发银行
Monda Organizaĵo pri Sano	世卫组织，世界卫生组织，世卫
mondfama	闻名世界
mondo	世界，世
monereta mono	零钱
monero	硬币
monkesto	保险箱
monludi	赌博
mono	金钱
monoftongo	单元音
monstro	怪物
monteto	山丘，小山
monto	山
montra fingro	食指
montra pronomo	指示代词，指示词
montri	给…看
montrofenestro	橱窗
monujo	钱包
moralo	道德
morfemo	基本词汇
morfologio	词法，形态，构词学
morgaŭ	明，明天
morti	去世
mortigi	杀死，杀
morto	死亡
mortpuno	死刑
morusarbo	桑树，桑
moskeo	清真寺
moskito	蚊，蚊子
motivo	动机
motorciklo	机车
movi	移动，活动
movlibero	活动的余地，活动的空间
movo	行动
mueldento	臼齿
muko	黏液
mulo	骡，骡子
multa	多
multaj	多
multĉelula	多细胞
multĉelula organismo	多细胞生物
multekosta	贵
multfoje	多次
multsignifa	很有意思
multspeca	多种
mumio	木乃伊
Munkena Interkonsento	慕尼黑协定
Munkena Konferenco	慕尼黑会议
murdi	谋杀
murdinto	凶手
muro	墙壁
murpapero	壁纸
muŝkaptilo de Venuso	捕蝇草
muskatarbo	肉豆蔻树
muskoj	苔类，苔，青苔，苔衣，苔藓
muskola histo	肌组织
muskola sistemo	肌肉系统
muskolo	肌，肌肉
muso	老鼠，鼠标器，鼠
muŝo	苍蝇，蝇
mustelo	黄鼠狼
muzeo	博物馆
muzikgrupo	乐队
muzikilo	乐器
muzikistaro	音乐团体
muzikisto	音乐家
muziko	乐，音乐
Muzoj	缪斯，诗歌女神缪斯姐妹
nacia himno	国歌
nacilingvo	民族语，母语
Nagario	天城文
naĝbaseno	游泳池
naĝi	游泳
naĝilo de ŝarko	鱼翅，翅
naiva	天真
najbara	隔壁
najbaro	邻居
najtingalo	夜莺
nana stelo	矮星
Nanĉango	南昌
Nankingo	南京
Nanningo	南宁
narcisfloro	水仙花
narciso	水仙花
Narciso	那西塞斯
naski	生，生下
naskiĝdato	出生日期
naskiĝfesto	生日宴会
naskiĝi	生，出生
naskiĝis	生于
naskiĝtago	生日
naskokanalo	产道
natrio	钠
natura	天然
naturdotita	有才能
naturo	自然
naŭ	九
naŭ mil	九千
naŭ miliardo	九十亿
naŭ miliono	九百万
naŭa	第九
naŭcent	九百
naŭcent mil	九十万
naŭcent miliono	九亿
naŭdek	九十
naŭdek du	九十二
naŭdek kvar	九十四
naŭdek kvin	九十五
naŭdek mil	九万
naŭdek miliono	九千万
naŭdek naŭ	九十九
naŭdek ok	九十八
naŭdek sep	九十七
naŭdek ses	九十六
naŭdek tri	九十三
naŭdek unu	九十一
naŭdeka	第九十
naŭfoje	九次
naŭoble	九倍
naŭono	九分之一
naŭza	恶心，恶
naza	鼻的，鼻音的
naza sinuso	鼻窦
nazia Germanio	纳粹德国
nazkataro	感冒
nazmuko	鼻涕
nazo	鼻，鼻子
nazradiko	鼻梁
naztruo	鼻孔
naztuko	手帕
ne	非，不了，不
ne dankinde	不谢，不用谢谢，不客气，不用谢
ne devus	不应该
ne dificila	不难
ne ekzisti	没有
ne estas permesita	严禁
ne esti	不是，没有
ne ĝenu min	别烦我
ne gravas	不要紧，没关系
ne havi	没有
ne malbona	不错
ne malbone	还好，不错
ne malfacila	不难
ne morala	不道德
ne nepre	未必，不一定，不见得，也不一定
ne nur	不只，不止，不但
ne nur... sed eĉ...	不但…还…
ne plu	不再
ne virta	不道德
ne voli	不要
ne ~u	别～，不要
Ne-Registara Organizaĵo	非政府组织
nea	消极
nea vorto	否定词
neatendita	想不到
nebulo	雾气
nebulozo	星云
neceseja papero	卫生纸
neceseja seĝo	马桶
necesejo	厕所
necesseĝo	马桶
necesujo	马桶
nedankinde	不谢，不用谢谢，不用谢，不客气
nedaŭra	暂时
nedeklinaciebla	词尾不变
nedeklinaciebla vorto	词尾不变词
nedifinita artikolo	不定词
neebla	不可能
neelparolata litero	不发音字母
neforgesebla	难忘
negativo	否定词
neĝbulo	雪球
neĝero	雪片，雪花
neĝhomo	雪人
neĝi	下雪
neĝo	雪
negocisto	商人
negoco	生意
nei	否认
nek	也不
nekredebla	不可思议
neleĝa	不合法，非法
nelonge	一回儿
nenia problemo	没问题
neniam	从没
neniu	谁都不，没有人，无人，没人，谁不
nenormala	不正常
neodimo	钕
neono	氖
neordinara	非常
nepra	绝对
nepre	必，一定，一定
nepre ne	一定不，决不
neptunio	镎
Neptuno	涅普顿，海王星
Neptuno I	海卫一
nerekta objekto	间接宾语
nerekta parolo	间接引语
nerva sistemo	神经系统
nervo	神经
neseksa	无性
netransitiva verbo	不及物动词
netuŝuminfloro	凤仙花
netuŝumino	凤仙花
neŭtra	中性
neŭtra genro	中性
neŭtra substantivo	中性名词
neŭtra vorto	中性词
neŭtrono	中子
neŭtronstelo	中子星
nevenkebla	无敌
ni	我们
ni ~u	不如
nia	我们的…
nia mem	我们自己
nia propra	我们自己的
nigra	黑色，黑
nigra humuro	黑色幽默
nigra tabulo	黑板
nigra truo	黑洞
nikelo	镍
nikotiano	烟草
nin	我们
Ningŝjao	宁，宁夏
niobo	铌
nitrogeno	氮
nivelo	程度
nobelio	锘
nocio	概念
nokto	夜晚，夜
noktomezo	午夜
nombro	数字，数
nomi	叫
nomiĝi	叫做，叫
nominativa kazo	主格
nominativo	主格
nomo	名，名字
nomo de Ĝingis-Ĥano	铁木真
nomumi	提名
Nord-Atlantika Traktat-Organizaĵo	北约，北约组织，北大西洋公约组织
norda cervo	驯鹿
Norda kaj Suda Dinastioj	南北朝
Norda Song-dinastio	北宋
nordo	北方
norma	普通，标准
normala	正常
normĉina	普通话，国语
noti	做笔记
notlibro	笔记本
noto	笔记，备忘录，成绩
nova	新
novaĵoj	新闻
novao	新星
novembro	十一月
nuba	多云
nubo	云
nuklea centralo	核能发电厂，核电厂，核电站
nuklea fendiĝo	核分裂
nuklea kunfandiĝo	核融合，核聚变
nuklea reakcio	核反应
nul	零，〇
nuligi	取消
numero	号码，号
nun	现在
nur	只，而已
Nurenberga proceso	纽伦堡审判
nutra	营养
oazo	绿洲
objektiva	客观
objekto	宾语
oblo	倍
observi	观察
obstina	固执，顽固
Odiseo	奥德修斯
ofendi	侮辱，冒犯
ofendiĝi	感到冒犯
oferi	牺牲，牲，牺
oficejo	办公室
oficiala	官，官方
oficista rango	官
oficisto	官
ofta	频繁的，经常的
ofte	常，常常
ok	八
ok mil	八千
ok miliardo	八十亿
ok miliono	八百万
oka	第八
okazaĵo	机会，事件
okaze	偶然，碰巧
okazi	发生
okazigi	导致，引起，使发生
okazo	机会
okcent	八百
okcent mil	八十万
okcent miliono	八亿
okcidenta	西方的，西边的，西部的
Okcidenta Ĝin-dinastio	西晋
okcidenta kulturo	西方文化
Okcidenta Ŝja-dinastio	西夏
okcidento	西方
okcipita lobo	枕叶
okdek	八十
okdek du	八十二
okdek kvar	八十四
okdek kvin	八十五
okdek mil	八万
okdek miliono	八千万
okdek naŭ	八十九
okdek ok	八十八
okdek sep	八十七
okdek ses	八十六
okdek tri	八十三
okdek unu	八十一
okdeka	第八十
okfoje	八次
okoble	八倍
okono	八分之一
okromarbo	西印度轻木
okromo	西印度轻木
oksigeno	氧
oktobro	十月
okulglobo	眼球
okulharo	睫，眼睫毛，睫毛
okulisto	眼科医生
okulkavo	眼窝
okulo	眼，睛，目，眼睛
okulumi	凝视，盯着看
okulvitroj	眼镜
okupata	没空，忙碌，忙
ol	比
Olimpikoj	奥运会，奥运
olivarbo	榄，橄，橄榄树
omaro	龙虾
ombrelo	雨伞
ombro	影，影子
ondego	巨浪
ondo	浪，波浪
onidiro	谣言
onomastiko	姓名学
onomatopeo	象声词
OPEL	油组
operacio	手术
operaciumo	操作系统
opero	歌剧
opinio	意见，看法
oportuna	方便
optika iluzio	光幻觉，光学幻觉，错视
optika nervo	视神经
optiko	光学
optimisma	乐观
ora	金
oranĝa	橘色
oranĝa stelo	橙星
oranĝarbo	橙，橙树
oranĝkolora	橘色
orbito	眼窝
orcino	虎鲸
orda	整洁
ordigi	整理
ordinara	平常，普通
ordoni	命令
ordono	命令
orela lobo	耳垂
orelkonko	耳廓，外耳
orellobo	耳垂
orelo	耳，耳朵
orelringo	耳环
orelvakso	耳垢
oretamburo	鼓膜
orfejo	孤儿院
Orfeo	俄尔甫斯
orfo	孤儿
organeto	细胞器
organika	有机
organismo	生物
organizaĵo	机构，组织
Organizaĵo de Petrol-Eksportaj Landoj	油组，石油输出国组织
Organizaĵo de UN por Edukado, Scienco kaj Kulturo	联合国教育科学文化组织
Organizaĵo por Ekonomia Kunlaboro kaj Evoluo	经济合作发展组织，经合发组织
Organizo de la Islama Konferenco	伊斯兰会议组织
organo	器官
Orienta Ĝin kaj la Deksesa-Reĝlandoj	东晋十六国
Orienta Ĝin-dinastio	东晋
orienta kulturo	东方文化
orientamerika larikarbo	美洲落叶松树，美洲落叶松
orientamerika lariko	美洲落叶松树，美洲落叶松
oriento	东方
oriento kaj nordo	东西
originala	独到
origine	本来
orkido	兰，兰花
orko	虎鲸
orkolora	金，金色
ornitorinko	鸭嘴兽
oro	金
Orostelo	金星
orpluvfloro	金链花
orpluvo	金链花
ortodoksismo	希腊正教
orvergo	秋麒麟草
oscedi	打哈欠
oscedo	哈欠
osmantarbo	桂花树
osmanto	桂花树
osmantofloro	桂花，桂
osmio	锇
osta histo	骨组织
osta medolo	骨髓，髓
ostaro	骷，髅，骨骼，骨架，骷髅
osto	骨头，骨
ostohisto	骨组织
ostro	牡蛎，蛎
ovodukto	输卵管
ovujo	卵巢
pacienca	有耐心
pacienco	耐心
packontrakto	和约
paco	和平，安
pafilego	炮
pagi	付钱，付给
paĝo	页
pajlo	稻草
pakaĵo	行李
paketo	包裹
pakvagono	行李车
paladio	钯
palindromo	回文
Palio	巴利语
palisandro	蔷薇树，花梨树，花梨木树，花梨木，黄檀树，蔷薇木，黄檀木
palmo	棕，棕榈，棕榈树，榈
palpebro	眼皮
palpi	摸，抓，触摸
palto	外套，大衣
pampelmusarbo	柚，柚树，柚子树
panarbo	木波罗树，面包果树，面包树，木波罗
pando	熊猫，猫熊
Pandora	潘多拉
panero	面包屑
paniko	恐慌
panisto	面包师傅
pankreaso	胰，胰脏
pano	面包
panrostilo	烤面包机
pansaĵo	绷带
pantalono	裤子
pantoflo	拖鞋
papago	鹉，鹦，鹦鹉
papajarbo	木瓜树
papavetfloro	虞美人花，虞美人
papaveto	虞美人，虞美人花
papavfloro	罂粟花
papavo	罂粟花
paperkorbo	废纸篓
papero	纸，纸张
papilio	蝶，蝴蝶，蝴
paragrafo	段，段落
paralela	平行
paraŝuto	降落伞
parazito	寄生物
pardoni	原谅
pardonon	对不起
pardonu min	很抱歉
parenca	亲
parencaro	亲戚
parenco	亲属，亲戚
parfumo	香水
parieta lobo	顶叶
Pariza Packonferenco	巴黎和会，巴黎和会
Pariza packontrakto	巴黎和约，巴黎和约
parkejo	停车场
parko	公园
parolado	演讲
parolas esperanton	讲世界语
paroli	说话，讲话，会
paroli esperante	说世界语，讲世界语
paroli esperanton	说世界语
parolilo	喇叭
parolo	语，言语，腔
participo	分词
partieco	偏见
partiklo	粒子
partikulo	助词
partio	政党，党，派对
Partio de Eŭropaj Socialdemokratoj	欧洲社会党
parto	部分
parto de parolo	词类
partopreni	参加
pasero	麻雀，雀
pasi	经过
pasinteco	过去
pasio	激情
pasiva	被动
pasiva participo	被动分词
pasiva voĉo	被动语态
pasivo	被动语态
paŝo	步调，步，脚步
pasporto	护照
patelo	膝盖骨
patriĉo kaj filiĉo	父子
patriĉo kaj filino	父女
patriĉofiliĉa	父子
patriĉofilina	父女
patrino kaj filiĉo	母子
patrino kaj filino	母女
patrino kaj filo	母子
patrinofila	母子
patrinofiliĉa	母子
patrinofilina	母女
patrio	故乡
patriota	爱国
patriotismo	爱国主义
patro kaj filino	父女
patro kaj filo	父子
patrofila	父子
patrofilina	父女
patroli	巡逻
paŭzi	休息
peco da papero	一张纸
pediko	虱
Pegazo	飞马
pego	啄木鸟
pejzaĝo	风景，景
Pekino	北京，京
pektoralo	胸大肌
pelargonifloro	天竺葵
pelargonio	天竺葵
pelikano	鹈，鹕，鹈鹕
pelvo	骨盆
penado	努力
pendumo	绞刑
peni	力图，试图，争取
peno	努力，力气
pensadi	思考
pensado	思想
pensi	觉得，想
pensi ke	认为
pensio	退休金，养老金
pensmaniero	想法
penso	念头
penti	忏悔
pentraĵo	画
pentri	画画
pentri pentraĵon	画画
pentristo	画家
peonifloro	牡丹，牡丹花
peonio	牡丹花，牡丹
peono	兵
per	用
pera	间接
peranto	经纪人
perdi	失，失去
perdiĝi	迷路
perfekta	完美
perfidi	背叛
perforta	暴力
perforto	暴力
perikardo	心包
Periodo de la Deksesa-Reĝlandoj	十六国
Periodo de la Orienta Ĝin kaj la Deksesa-Reĝlandoj	东晋十六国
Periodo de la Tri Reĝlandoj	三国时代，三国
permesilo	执照
persekutado	迫害
persekuti	迫害
Perseo	珀耳修斯，珀修斯
persikarbo	桃，桃树
persikfloro	桃花
persona	个人
persona pronomo	人称代词
personeco	个性
persono	人
pesilo	磅秤
pesimisma	悲观
petalo	瓣，花瓣
petola	淘气，胡闹
petolaĵo	恶作剧
petolema	调皮的，爱胡闹的
petoli	胡闹，捣蛋
petunifloro	矮牵牛花
petunio	矮牵牛花
peza	重
peza industrio	重工业
pezo	重量，体重
piano	钢琴
picearbo	云杉树，云杉
picejo	匹萨店，披萨店，比萨店
piceo	云杉，云杉树
pico	披萨，匹萨，比萨，比萨饼，披萨饼，匹萨饼
piedfingro	脚趾头，趾
piediranto	行人
piedo	足，脚
piedspuro	脚印，足迹
pika	辣的，有刺的，有倒钩的
pika gusto	辣味
pikdrato	铁丝网
pikilo	刺，倒钩
pikniko	野餐
pilgrimado al Mekao	麦加朝圣
Pilgrimo al la Okcidento	西游记
pilo	电池
pinarbo	松，松树
pinglo	别针
pingveno	企鹅
pino	松，松树
piramido	金字塔
pirarbo	梨，梨树
pirato	海盗
pistilo	雌蕊
pistilo de floro	雌蕊
pituitaria glando	脑垂腺
pivotradiko	直根，主根
pizo	豌豆
placento	胎盘
plaĉi	取悦
plaĉi al	喜欢
placo	广场
plafono	天花板
plaĝo	沙滩
plando	脚底
planedo	行星，星球，惑星
planko	地板
plano	计划
plantejo	农园
planto	植物
plasto	塑胶
platanarbo	悬铃木树，梧，梧桐，悬铃木，桐，梧桐树
platano	悬铃木树，梧桐树，悬铃木，桐，梧，梧桐
plateno	铂
platikodonfloro	僧帽花，铃铛花，桔梗
platikodono	桔梗花，桔梗，铃铛花，僧帽花
pledi	辨护
plej	最
plejparto	大多数，大部分
plena	满
plena da	充满了
plendi	抱怨
plendo	牢骚，怨言
plenkreska	成人
plenkreskulo	成人，大人
plenluno	满月
plezura	愉快
pli	比较，较，更
pli kaj pli	越来越
pli kaj pli bone	越来越好
pli malfrue	晚一点
pli malpli	差不多
pli multa	多一点
plia	额外
plialtigi	增加
plibonigi	改善
pliboniĝi	改进，变得更好
pliboniĝo	进步
plifortigi	增强
plimulta	更多
plimultigi	增加
pliposte	晚一点
plori	哭，流眼泪，哭泣，流泪
plorsalikarbo	垂柳，垂柳树
plorsaliko	垂柳，垂柳树
plu	多一点
plumbo	铅
plumo	羽毛，笔，羽
pluraj	多
plurala finaĵo	复数词尾
plurala pronomo	复数代名词，复数代词
pluralo	复数
plurjara	多年生
plurjara herbo	多年生草本
plutonio	钸，钚
Plutono	冥王星，普鲁托
pluvero	雨滴
pluvi	下雨
pluvmantelo	雨衣
pluvo	雨
poema	诗意
poemaro	诗集
poemo	诗歌
poeto	诗人
poezia	诗意
pojno	手腕，腕
polekso	大拇指
polemiko	争议
poleno	花粉
policano	警察，警察人员
policejo	警察局
policisto	警察，警察人员
polico	警察，警
politiko	政治，政策
polonio	钋
polpo	章鱼
polusa urso	北极熊
polvo	尘土，灰
polvoŝovelilo	畚箕
polvosuĉilo	吸尘器
pomarbo	苹，苹果树
poplarbo	白杨树，白杨
poplo	白杨树，白杨
popolkanto	民谣，民歌
popolo	人民，民
populara	流行，红
por	为了
pordego	门
Pordego de Ĉiela Paco	天安门广场
pordo	门户，门口，户，门
porko	豚，豕，猪
poro	毛孔
poŝdiskilo	随身听
poseda kazo	所有格
poseda pronomo	所有格代名词
posedaĵo	财产
posedi	拥有
posedo	所有格
poŝkasedilo	随身听
poŝlanterno	手电筒
poŝo	口袋
post	后，以后
poŝtaĵo	邮件
postbrako	膀
postdrinka kapdoloro	宿醉
poste	以后，然后
postebrio	宿醉
poŝtejo	邮局
poŝtisto	邮差
poŝtkarto	明信片
postkuri	追赶
poŝtmarko	邮票
poŝto	邮
poŝtoficejo	邮局
postparto de kolo	项
postpozicio	后置词
postsigno	线索
postsono	回声
posttagmezo	下午
poŝtuko	手帕
postuli	要求
postulo	要求
postvango	屁股
potencebla	潜在
potenciala	潜在
Potsdama Konferenco	波茨坦会议
povi	能，会，可以
poviga	潜在
Pozidono	波塞冬
pozitiva	积极
praavoj	祖先
praĉelo	干细胞
Praeksplodo	大爆炸
praktika	实际
prapatroj	祖先
prava	真实
pravi	说得对
prazeodimo	镨
precipe	尤其
predikato	述语，谓语，动词谓语
prefikso	字首，前缀
preĝi	祷告，礼拜
preĝo	祈祷
premi butonon	按电钮，按钮
premiiĝi	中奖
premo	压力，压强
premolaro	前臼齿
premsonĝo	噩梦，梦魇，恶梦，魇
preni	拿
preni la tutan respondecon	负全部责任
prepozicio	前置词，介词
presilo	打印机
preskaŭ	差点，几乎
preskaŭ nenio	几乎没有
preskaŭ neniu	几乎没有
preta	准备好了
preteksto	借口
preterita participo	过去分词
preterita tempo	过去式
pretiĝi	准备
pretigi	准备
pretpansaĵo	绷带
preventi	阻止
prezenca tempo	现在时
prezenti	介绍
prezidanto	总统
prezkonjekto	预算
prezo	价格
pri	关于
primoki	嘲笑
primolfloro	报春花，樱草花
primolo	樱草花，报春花
princino	公主
princo	王子
printempo	春，春天
pripensi	考虑
priskribi	形容
privata	私人，私
privateco	隐私
priverŝi	浇水，浇
prizorgi	照顾
pro tio	所以
probablo	机会率，概率，机率，或然率
problemo	问题，麻烦
procedi	进行
procedo	手续
procezo	过程
prociono	浣熊
produkti	产生
produkto	产品
profesia	职业
profesio	行业
profesoro	教授
profetaĵo	预言
profeto	先知
profito	利润
profunda	深
programaro	软件
programo	节目
progresi	进步
progreso	进步
prokarioto	原核生物
proksima	近
proksimaĵo	附近
proksimulo	邻居
proksimume	左右
promeni	散步
promesi	答应
promeso	承诺
Prometeo	普罗米修斯
prometio	钷
pronomo	代词，代名词
prononcmaniero	口音
prononco	发音
proponi	建议
propono	建议，提议
propozicio	从句，子句
propra	私人，私，自己的
propra nomo	专有名词
propraĵo	财产
propraokule	亲眼
propraokule vidi	亲眼看到
prospera	繁荣
prostato	摄护腺，前列腺
protaktinio	镤
proteino	蛋白质
protekti	保护
protestantismo	新教
protesti	抗议
proton	质子
provi	试，试图，尝试
provinco	省，省份
provizejo	仓库
provizi	提供
provizora	暂时
provizore	临时
provizumi	供应
provtubo	试管
prunarbo	李树，李
prunelarbo	黑刺李树，黑刺李
pruntedoni al	借给
pruntepreni libron	借书
pruntepreni monon	借钱
prunti al	借给
prunti libron	借书
prunti monon	借钱
prunto	贷款
pruvi	证明
pruvo	证据
psikologo	心理学家
publika	公用，公
publika telefono	公用电话
pugno	拳头，拳
pugo	屁股
pulma arterio	桡动脉，肺动脉
pulmo	肺脏，肺
pulo	蚤，跳蚤
pulsaro	脉冲星
pulso	脉搏
pulsostelo	脉冲星
pulvoro	粉末
pumo	美洲狮
puni	处罚
puno	惩罚
pupilo	瞳，瞳孔
pupo	傀儡
pura	干净
pura alkoholo	酒精
purigi	清洁
purpura	紫色，紫
puŝi	推
puŝo	推
puso	脓
puŝveturilo	手推车，独轮推车
puto	井
racieco	理性
racio	道理
radaro	雷达
radikalulo	激进分子
radiko	树根，根，词根
radio	收音机
radiumo	镭
radiuso	桡骨
radono	氡
rajdi sur ĉevalo	骑马
rajti	可，可以
rajto	权利
raketo	火箭
rakonti	告诉
rakontintrigo	剧情
rakonto	故事
Ramadano	斋戒月
ranido	蝌蚪，蝌，蚪
rano	蛙，青蛙
rapida	快
rapideco	速度
rapidi	赶
rapidi al	赶往，赶到
rapidvagonaro	快车
raporti	报导
raporto	报告
raŭpo	毛毛虫
re	再
reago	反映
reala	真，真正
realaĵo	现实
rebonigi	修理
red dwarf	红矮星
redaktisto	编辑
redaktoro	编辑
redoni	还给
refleksiva pronomo	反身代词
regi	控制
reĝino	女王
regiono	区
reĝisoro	导演
registaro	政府
reĝlando	王国
reĝo	王，国王，王
regulo	规则
reĝustigi	调整
reiri	回去
reiri hejmen	回家
reklamo	广告
rekomendi	推荐，荐
rekompenco	报酬
rekoni	辨认
rekordo	纪录
rekta	直接
rekta objekto	直接宾语
rekta parolo	直接引语
rektangulo	长方形
religio	宗教，教
rendevuo	约会
renio	铼
renkonti	见面，见，遇到，见面
renkontiĝi	见面
reno	肾脏，肾
repagi	偿还，还钱
reprezenti	代表
reprodukta organo	生殖器官，生殖器
reprodukta sistemo	生殖系统
reptilio	爬虫类
resanigi	医
resono	回声
respekti	尊重
respekto	尊敬
respondaparato	答录机
respondeca	负责
respondeci pri	负责，负责任，为…负责
respondeco	责任
respondeculo	负责人
respondi	回答
respondo	答案
restanta dento	恒齿
resti	留，留在，保持
restmono	零钱
restoracio	餐厅
retino	视网膜
reto	网络，网，络
retotaglibro	部落格，博客
retpaĝaro	网页
retpoŝt-adreso	伊妹儿地址，电子邮件地址，电邮地址
retpoŝto	电子邮件，电邮，伊妹儿
reveni	回来
revi	作白日梦
revidi	再见
revo	白日梦
revolucio	革命
revuo	杂志
rezino	树脂
rezisti	抵抗
rezona	合理
rezulto	结果
ribonukleata acido	核糖核酸
ribosomo	核糖体
riĉa	有钱
riĉeco	财富
ricevatesto	收据
ricevi	收到
ridado	笑声
rideti	微笑
rideto	笑容
ridi	乐，笑
ridiga	好笑
ridinda	可笑
ridmieno	笑脸
rifuĝinto	难民
rifuzi	拒绝
rigardi	看
rilato	关系
rimarki	注意
rimarkinda	值得注意，异常，非凡
rimedo	资源
ringa fingro	无名指
ringo	戒指
rinocero	犀，犀牛
ripari	修理
ripkaĝo	肋骨架
ripo	肋骨，肋
ripozi	休息
risorto	弹簧
rivero	河，江，河流，川
rizo	大米饭，饭，米，米饭，大米，稻米
rizokampo	稻田
rizomo	根状茎，根茎
rizvino	清酒
RNA	核糖核酸
robinio	洋槐树，刺槐，刺槐树
roboto	机器人
rodio	铑
roko	岩石
rolo	角色
romano	小说
romantika	浪漫
romia mitaro	罗马神话
romia mitologio	罗马神话
rompi	打破，弄坏，打碎，破坏
rompiĝema	易碎，脆弱
rompita	坏了，弄坏的，破碎的
rompŝtelisto	窃贼
rondo	圆形
ronĝulo	齧齿类
rosmaro	海象
rozfloro	玫瑰，玫瑰花，月季花，蔷薇，蔷，玫，蔷薇花，瑰
rozkolora	粉红色，粉，粉红
rozo	蔷，玫，玫瑰，蔷薇花，蔷薇，瑰，月季花，玫瑰花
rubando	丝带
rubidio	铷
ruboj	垃圾
rubujo	垃圾桶
rudbekifloro vila	黑心菊，黑心菊花，金光菊，金光菊花
rudbekio vila	金光菊，金光菊花，黑心菊花，黑心菊
ruĝa	红色，红
ruĝa giganto	红巨星
Ruĝa Krescento	红新月会
Ruĝa Kruco	红十字会
ruĝa ligno	红杉树，红杉
ruĝa sanga korpusklo	红血球，红细胞
ruĝa stelo	红星
ruĝgorĝulo	知更鸟
ruĝiĝi	脸红
ruĝligno	红杉，红杉树
ruinigi	破坏
rulseĝo	轮椅
rusti	生锈
rusto	锈，铁锈
rutenio	钌
ruza	狡猾
ruzaĵo	诡计
ruzo	诡计
sabato	星期六，周六，六，礼拜六
sablero	沙粒
sablo	沙子
ŝablono	模式
sadisto	虐待狂
ŝafaĵo	羊肉
ŝafido	小羊
ŝafino	母羊
ŝafo	羊
saĝeco	智慧
saĝo	智慧
sago	矢，箭
saĝodento	智齿
ŝajne	显然
ŝajni	好像
ŝajni ke	好像
ŝakludi	对弈，弈，下棋
ŝakludo	棋，西洋棋
sako	袋子
ŝako	西洋棋，棋
ŝakpeco	棋，棋子
ŝaktabulo	棋盘
sala	咸的
sala akvo	咸水
sala gusto	咸味
salajro	薪水
sali	撒盐，加盐
salikarbo	杨柳，柳树，杨柳树，柳
saliko	柳，杨柳树，柳树，杨柳
salikoko	虾子，虾
salivi	垂涎
salivo	口水，唾液
salivtuketo	围嘴
salivumi	流口水
salmo	鲑鱼，鲑
salo	盐，盐巴
salsolo	风滚草
ŝalti lampon	开灯，开电灯，打开电灯
ŝaltilo	开关
saluto	招呼
saluton	嗨，你好
sama	同，一样
samario	钐
sambukarbo	接骨木，接骨树，接骨木树
sambuko	接骨木，接骨木树，接骨树
samĉambrano	室友
same kiel antaŭe	依旧，依然，照样，依，照旧
samlandano	同胞
samnoma	同音词，同音字
ŝampuo	洗发精
samseksema	同志
samsonoras kiel	听起来像
samspeca	类似
samtempe	同时
sana	健康
Ŝandongo	山东，鲁
Ŝang-dinastio	商朝
ŝanĝi	改变
sangi	流血
ŝanĝiĝi	变
ŝanĝiĝo	变化
ŝanĝo	变化
sango	血液
sangoĉelo	血细胞，血球
sangocirkula sistemo	循环系统
sangoverŝo	流血
Ŝanhajo	上海，山西，晋
sankta	神圣
Sankta Romia Imperio	神圣罗马帝国
Sanktejo Jasukuni	靖国神社
sano	健康
Ŝanŝjio	沪
Sanskrito	梵文，梵语
sapo	肥皂
sardelo	沙丁鱼
sarkasma	讽刺
ŝarko	鲨鱼，鲨
satelito	卫星
ŝati	喜欢，欣赏
Saturno	土星
ŝaŭmo	泡沫
sceno	场面
sciencisto	科学家
scienco	科学
scii	知，知道
sciiĝi	得知
sciigi	通知
scio	知识
scipovi	会
sciuro	松鼠
scivola	好奇
se	如果
se vi ne zorgas	如果你不介意的话
sed	但，可，可是，但是
seĝo	椅子
ŝejko	酋长
seka	干，干的
sekala pano	黑面包
sekalo	裸麦，黑麦
sekalpano	黑面包
sekeco	干燥
sekiga tuko	擦干杯盘餐具等的抹布
sekigi	使变干
sekiĝi	变干
sekigita toŭfuo	豆干
sekretariejo	秘书处
Sekretariejo de UN	联合国秘书处
sekretario	秘书
sekreto	秘密
sekso	性，性别
seksvivo	性生活
sekundo	秒钟，秒
sekura	安全
Sekureca Konsilio	安理会
sekureco	安全性
sekvaj	下列
sekvanta	下个
sekve	于是
sekve de tio	于是
sekvojarbo	红杉树，加州红木，巨杉树，世界爷树，巨杉，水杉树，世界爷，红杉，水杉
sekvojo	加州红木，世界爷，红杉树，世界爷树，水杉树，巨杉树，巨杉，水杉，红杉
seleno	硒
ŝelo	外壳，皮
selo	鞍，马鞍
semajnfino	周末
semajno	星期
semikonduktaĵo	半导体
semo	籽，种子，子，核，种
sen	无
senĉesa	不断
senĉese	不断，不停
senco	意义
sendanĝera	安全
sendanĝereco	安全性
sendependa	独立
sendi	寄给
senduba	无庸置疑
sendube	无疑
senĝena	不客气
senhaŭtigi	剥皮
senhava	穷的，穷苦的，穷困的
senhaveco	穷苦，穷困
senhavigi	剥夺，使失去
senhavulo	贫民，穷人
senhelpa	无助，无依无靠
senhonta	无耻
senhonte	无耻地，不知羞耻地
Ŝenjango	沈阳
senkapigi	斩首
senkulpa	无辜
senlabora	失业
senlaboreco	失业
senmorta	长生不老
sennoma fingro	无名指
senpaga	免费
senpolvigi	除尘，去掉～的灰尘
senprobleme	顺利
senŝeligi	剥皮，剥壳，去壳，削皮
senŝeligita	去壳的
senŝeligita rizo	糙米
sensenca	荒唐的，荒谬的
sensencaĵo	荒谬的事，荒唐的事
sensenceco	荒谬
sensignifa	无意义的
Ŝenŝjio	陕，陕西
sensperta	无经验的，不熟练的
senspira	喘不过气来的，气喘吁吁的
sentaŭga	没用，无用，不中用，毫无用处
sentaŭgulo	一无是处的人，没出息的人，无用的人，饭桶，废物
sentema	敏感
senti	觉得
sento	感觉
senutila	没用，无用
senvestiĝi	脱衣服
sep	七
sep mil	七千
sep miliardo	七十亿
sep miliono	七百万
sepa	第七
sepcent	七百
sepcent mil	七十万
sepcent miliono	七亿
sepdek	七十
sepdek du	七十二
sepdek kvar	七十四
sepdek kvin	七十五
sepdek mil	七万
sepdek miliono	七千万
sepdek naŭ	七十九
sepdek ok	七十八
sepdek sep	七十七
sepdek ses	七十六
sepdek tri	七十三
sepdek unu	七十一
sepdeka	第七十
sepfoje	七次
sepoble	七倍
sepono	七分之一
septembro	九月
ŝercema	爱开玩笑
ŝerci	开玩笑
serĉi	追求，找
ŝerco	笑话
serialo	连续剧
serio	系列
serioza	严肃
serpento	蛇
servi	服务
servo	服务
servu vin	请便
ses	六
ses mil	六千
ses miliardo	六十亿
ses miliono	六百万
sesa	第六
sescent	六百
sescent mil	六十万
sescent miliono	六亿
sesdek	六十
sesdek du	六十二
sesdek kvar	六十四
sesdek kvin	六十五
sesdek mil	六万
sesdek miliono	六千万
sesdek naŭ	六十九
sesdek ok	六十八
sesdek sep	六十七
sesdek ses	六十六
sesdek tri	六十三
sesdek unu	六十一
sesdeka	第六十
sesfoje	六次
sesoble	六倍
sesono	六分之一
Seulo	汉城，首尔
severa	严，严格
severe	严
sezono	季节
sfagnoj	水苏
Shijiazhuang	石家庄
ŝi	她
ŝia	她的
ŝia propra	她自己的
Siĉŭano	川，四川
sidejo	座位
sidi	坐
sidi ĉetable	入席
sidiĝi	坐下
sidloko	座位
sidvango	大臀肌，屁股
signalo	信号
signifi	代表，表示
signifo	意义，含义，意思
signo	符号，字
Signolingvo	手语
sikhismo	锡克教
sikomorarbo	美国梧桐树，美国梧桐
sikomoro	美国梧桐，美国梧桐树
silabo	音节
ŝildo	盾
silento	沉默
silicio	矽，硅
simboli	象征
simbolo	象征
simila	类似，似，很像，像
simileco	明喻
simio	猴，猴子
simpla	简单
simple	简直
ŝin	她
sin intermeti	干涉
sincera	诚恳
sincereco	诚意
singarda	小心
singardema	小心
sinĝena	害羞
sinĝenema	害羞
Ŝinĝjango	新疆，新
singulara finaĵo	单数词尾
singulara pronomo	单数代词，单数代名词
singularo	单数
sinonimo	同义字，同义词
sintakso	句法
sinteno	态度
sinuso	鼻窦
ŝipestro	船长
ŝirdento	裂齿
sireno	海牛，美人鱼
siringfloro	紫丁香花，紫丁香
siringo	紫丁香花，紫丁香
ŝirmejo	避难所，庇护所
ŝirmi	保护，庇护
ŝirmilo	避难所，庇护所
ŝirmo	避难所，庇护所
ŝirmtegaĵo	防尘布，防尘罩，防护罩
sistemo	系统
sitelo	水桶
situacio	情况，场合
situi	位于
Ŝja-dinastio	夏朝
Ŝjiano	西安
Ŝjiningo	西宁
skandalo	丑闻
skandio	钪
skapolo	肩胛骨
skarabo	甲虫
skatolmalfermilo	开罐器
skatolo	盒子
skeleta sistemo	骨骼系统
skeleto	骷，髅，骷髅，骨架，骨骼
sklavo	奴，隶，奴隶
skorpio	蠍子，蠍
skribi	写，写字
skribmaŝino	打字机
skribo	文
skribotablo	写字台，书桌
skribtablo	书桌
skulptaĵo	彫刻品，雕像
sledo	雪橇
ŝlosi	锁上
ŝlosila	关键
ŝlosilo	钥匙
ŝlosita	锁住的，锁定的
ŝloso	锁头
smeraldo	翡翠
ŝminki	化妆
ŝminko	化妆品
ŝnuro	绳索
socia kontrakto	社会契约
socio	社会
sofo	沙发
soforarbo	槐树，槐
soforo	槐树，槐
soifa	口渴
sojfaba lakto	豆浆
sojfabo	大豆，黄豆
soldato	兵，军人，卒
soleca	寂寞
solidago	秋麒麟草
solidigi	固化
solido	固体，固体
solvi	解决
somero	夏，夏天
sonaparato	音响
sonbendo	卡带，录音带
Song-dinastio	宋朝
sonĝi	梦见，做梦，梦到
soni	听起来
soni simile	听起来很像
sono	声音
sonorilo	铃
sonserpento	响尾蛇
sopiri	渴望
sorbi	吸收
sorĉistino	巫婆
sorĉisto	巫师
sorparbo	欧洲花楸树，欧洲花楸，花楸，花楸树
sorto	命运，命
ŝoseo	高速公路
sovaĝa	蛮，野蛮
sovaĝa karoto	野胡萝葡
sovaĝa pomarbo	西府海棠树，海棠，西府海棠，海棠树
ŝovelilo	铲子
spaco	空间
spacotempo	时空
spadfiŝo	旗鱼
ŝpari	省
ŝpari monon	省钱，存钱
speciala	特，特别
speciala administra regiono	特别行政区
Speciala Relativeco	狭义相对论
speco	种类，种
spegulo	镜，镜子
spekti filmon	看电影
sperti	经历
sperto	经验
spertulo	专家
spina medolo	脊椎骨，脊，脊骨，脊髓
spino	脊椎
spiono	间谍
spira sistemo	呼吸系统
spiri	呼吸
spirito	心灵，精神
spongo	海绵
sporto	体育
spuro	迹
ŝranko	橱柜
ŝraŭbi	拧螺丝，拧螺钉
ŝraŭbilo	扳手，活动扳手
ŝraŭbingo	螺母，螺帽
ŝraŭbo	螺丝，螺钉
ŝraŭbŝlosilo	扳手，活动扳手
ŝraŭbtenilo	老虎钳
ŝraŭbturnilo	螺丝起子，螺丝刀
ŝtala	钢制的，钢铁的
ŝtalo	钢铁
stameno	雄蕊
standardo	国旗
stano	锡，锡
ŝtataneco	国籍
ŝtatestro	国家元首
ŝtatigi	使国有化
ŝtatigo	国有化
ŝtato	国家
stato	状态，状态
stato de materio	相态，物态，相
statuo	雕像
stebkovraĵo	被子
ŝtele	偷偷地，偷偷摸摸地
ŝteli	偷，窃取
ŝteliri	偷走，偷去
ŝtelisto	小偷
ŝtelo	偷窃，盗窃
stelo	星，恒星，星星
ŝtelrigardi	偷看
stelulo	明星
sterko	肥料
sternumo	胸骨
ŝtipo	木块
stomako	胃
ŝtonego	岩石
ŝtonhakisto	石匠
ŝtono	石头
ŝtopilingo	插座
ŝtopilo	插头
stranga	怪，奇怪，奇
strategio	策略
strato	街道
strigo	猫头鹰
striko	罢工
strikta	紧
strio	长条，条纹
stroncio	锶
strukturo	结构
ŝtrumpeto	袜子
struto	鸵鸟，鸵
studanto	学生
studento	生，大学生
studi	学习
studi	读书，学习，复习，念书
ŝtuparo	台阶，阶梯，楼梯，梯
ŝtupetaro	梯子，梯
ŝtupo	级，梯阶，阶
Ŝu-Reĝlando	蜀国
sub	以下，下，之下，下面
subbrako	腋，腋窝，胳肢窩
subĉemizo	汗衫
subhaŭta	皮下
subhaŭta histo	皮下组织
subita	忽然
subite	突然，忽然
subjektiva	主观
subjekto	主语
subjunkcio	虚拟语气
subskribi	签，签名
subskribi packontrakton	签和约
substantiva vortfinaĵo	名词词尾
substantivo	体词语，名词
substreki	强调
subŝtupare	楼下
subtaso	茶托，碟子
subtegmentejo	阁楼
subtegmento	阁楼
subteni	支持
subteno	支持
subtera	地下
subtitolo	字幕
subtitolo de filmo	电影字幕
subvencio	补助金
Suda Song-dinastio	南宋
sudo	南方
Suej-dinastio	隋朝
suferanto	被害人
suferi	忍耐，忍受，受苦
suffiĉe	够，足够
sufiĉe	蛮，挺
sufiĉe bona	蛮好，挺好
sufiĉega	丰富
sufikso	后缀，字尾
sugesti	建议
sukcese	顺利
sukcesi	成功
sukceso	成功
suko	树液
ŝulaĉo	鞋带
ŝuldi	欠缺
sulfuro	硫
sulka	皱皱的
ŝultro	肩，肩膀
sumakarbo	漆树
sumako	漆树
suna	晴朗
sunbrila	晴朗
sunleviĝo	日出
sunmakulo	太阳黑子
Suno	太阳
suno	日
sunsistemo	太阳系
sunsubiro	日落
sunvitroj	太阳镜
ŝuo	鞋子
supera	超级
superhomo	超人
superi	超过
superjaro	闰年
superkondukanto	超导体
superlativo	最高级
supernatura	超自然
supernovao	超新星
superrego	霸权
superstiĉa	迷信
superstiĉo	迷信
superŝtupare	楼上
supervendejo	超市
supraĵo	表面
supre	上面，楼上
sur	以上，之上，上，上面
surfaco	表面
surgenuiĝi	跪下
surmeti	冠
surmeti ĉapelon	冠
suro	腿肚子
surpriza	惊人
surprizita	惊讶
surprizo	惊喜
surrenaj glandoj	肾上腺
surtuto	大衣
surverŝi	浇水，浇
survoje	在路上
suspektato	嫌疑人
ŝviti	流汗
ŝvito	汗，汗水
T-ĉemizo	体恤
tabako	烟草
tablo	桌，桌子
tablotuko	桌布
tabulludo	棋盘游戏，图版游戏
tabulo	板子，木板
tagiĝo	黎明，黎
taglibro	日记
tagmezo	中午，午
tago	天，日
Taijuan	太原
taja skribo	泰文
Tajpeo	台北
tajpisto	打字员
Tajvano	台湾，台
taksi	估计
taksio	计程车
taksusarbo	紫杉，红豆杉，紫杉树，红豆杉树
taksuso	紫杉树，紫杉，红豆杉树，红豆杉
talento	才能
talio	腰部，铊，腰
talpo	鼹，鼹鼠
tamarindarbo	罗望子树，罗晃子树，酸果树
tamburo	鼓
tamen	不过
Tang-dinastio	唐朝
tantalo	钽
tapiro	貘
tapiŝeto	摊子
tapiŝo	地毯
taso	杯子，茶杯，杯
taso da teo	一杯茶
taŭgi	适合
taverno	酒店
tearbo	茶树
teatraĵo	剧，戏剧
teatraĵserio	连续剧
teatro	戏院
teda	无聊
teejo	茶馆
tegi	覆盖
tegilo	防护罩，覆盖保护层
tegmento	屋顶
teknecio	锝
tekniko	技术
teknologio	科技
teko	手提箱
tekruĉo	茶壶
tekstotraktado	文字处理
tektonarbo	柚木树
tektono	柚木树
telefon-numero	电话号码
telefonbudo	电话亭
telefondrato	电话线
telefoni	打电话
telefoni al	打电话给
telefonkarto	电话卡
telefonlibro	电话簿
telefono	电话
teleregilo	遥控器
teleskopo	望远镜
televida programo	电视节目
televida serialo	电视连续剧
televida stacio	电视台
televida teatraĵo	电视剧
televida teatraĵserio	连续剧，电视连续剧
televidaj novaĵoj	电视新闻
televidi	看电视
televidila ekrano	电视屏幕
televidilo	电视机
televido	电视
teluro	碲
temo	话题
temperamento	脾气
temperaturo	温度
tempio	太阳穴
tempo	时光，时，时间
tempomaŝino	时光机
temporala lobo	颞叶
Temuĝin	铁木真
tendenco	趋势
tendeno	腱，肌腱
tendo	帐篷
tenejo	仓库
teni	拿着，维持
tenilo	把手
tenso	时态
teo	茶
teorio	理论
teorio de Praeksplodo	大爆炸理论
teorio de relativeco	相对论
tepoto	茶壶
Terakota Legio	兵马俑
terbio	铽
teritorio	领土
terkulturo	农业
termino	术语
termito	白蚁
termometro	温度表
terni	打喷嚏
terno	喷嚏
tero	土地，土壤
Tero	地球
teroristo	恐怖分子
terpoma kaĉo	土豆泥，马铃薯泥
terpomo	土豆，马铃薯
terpomsenŝeliga tranĉilo	土豆削皮器
terrato	土鼠
Terstelo	土星
tertremo	地震
terura	坏透了
terure	要命
teruro	恐怖
testamento	遗嘱
testo	考试
testudo	乌龟
tetaso	茶杯
Tezeo	忒修斯
tezo	论文
tia	那种，然，那样，这么
tial	因此，所以
tial ke	既然
tiam	当时
tiamaniere	那样
Tian An Men-placo	天安门广场
tibeta skribo	藏文
Tibeto	西藏，藏
tibio	胫骨
tie	那里
tie kaj tie	到处，处处
tiel	这么
tiele	那样地，如此
tifao	香蒲
tifono	台风
tigro	老虎，虎
tigrolilifloro	卷丹，卷丹花
tigrolilio	卷丹花，卷丹
tikli	搔痒
tiliarbo	椴树，椴
tilio	椴，椴树
tima	害怕
timema	胆怯的，害羞的
timi	怕，害怕，惧怕
timigi	吓，使惊吓，使害怕
timo	恐惧
timo	恐惧
timoteo	猫尾草，梯牧草
timpano	鼓膜
tineo	蛾，飞蛾
tinkturo	染料
tinuso	鲔鱼，鲔
tio	那，那个
tio estas	那是
tio ne gravas	不要紧，没关系
tio-ĉi	这，这个
tio-ĉi estas	这是
tiom bona	那么好
tiom grava	那么严重
tiotempe	当时
tiraneco	暴政
tirano	暴君
tirkesto	抽屉
tiroida glando	甲状腺
titano	钛
tiu	那
tiu speco de	那种
tiu-ĉi	这，这种，这个
tiuj	那些
tiuj-ĉi	这些
tiuokaze	那么，那样，在这种情况下
Tjanĝino	天津，津
tolerema	忍心
toleri	容忍，忍耐
tolmarko	洗衣店作的标签
tolo	布
tombo	坟墓
tondilo	剪刀
tondro	雷声
tondro kaj fulmo	雷电
tonsiloj	扁桃腺
torako	胸部
torio	钍
tornistro	背包
toŭfuo	豆腐
tradicia	传统
traduki	翻译
tradukisto	翻译者
traduko	译文
trafi	遇到
trafiko	交通
tragedio	悲剧
traĥeo	气管
trajno	火车
traklisto	曲目
traktato	公约，条约
Traktato de Versajlo	凡尔赛和约，凡尔赛条约
trakti	处理，对待
traktoro	拖拉机
tramhaltejo	地铁站
tranĉilo	一把刀
tranĉilo kaj forko	刀叉
tranĉodento	门齿
tranĉtabulo	砧板
transitiva verbo	及物动词
transloĝiĝi	搬家
trapeza muskolo	斜方肌
traverŝilo	漏勺，滤器
tre	很
tre ĝena	很烦，很麻烦
treege	非常
tremi	颤抖
tremolarbo	杨，杨树
tremolo	杨树，杨
trezora	宝贵
tri	三
tri mil	三千
tri miliardo	三十亿
tri miliono	三百万
tri minutoj	三分钟
Tri Reĝlandoj	三国
tria	第三
tria persono	第三人秤
triangulo	三角形
tribo	部落
tricent	三百
tricent mil	三十万
tricent miliono	三亿
tricepso	三头肌
tridek	三十，卅
tridek du	卅二，三十二
tridek kvar	卅四，三十四
tridek kvin	三十五，卅五
tridek kvin minutoj	三十五分钟
tridek mil	三万
tridek miliono	三千万
tridek minutoj	三十分钟
tridek naŭ	三十九，卅九
tridek ok	三十八，卅八
tridek sep	卅七，三十七
tridek ses	三十六，卅六
tridek tri	三十三，卅三
tridek unu	卅一，三十一
trideka	第三十
trifoje	三次
trifolifloro	蓿，苜蓿，马草，白花三叶草，酢浆草，苜蓿花，苜，三叶草
trifolio	酢浆草，三叶草，白花三叶草，苜，马草，蓿，苜蓿花，苜蓿
trikapa muskolo	三头肌
trinkaĵo	饮料
trinkejo	酒吧
trinki	喝
trioble	三倍
triono	三分之一
tritiko	小麦
Tritono	海卫一
triviala	粗鲁
trivialaĵo	粗话
tro	太
troigi	夸张
Troja milito	特洛伊战争
trompi	欺骗
tropeolfloro	金莲花，旱金莲花，金芙蓉花，金芙蓉
tropeolo	金芙蓉花，金芙蓉，旱金莲花，金莲花
tropeza	超重
trovi	找到
trunka ĉelo	干细胞
trunko	树干，干，躯干
truo	孔
TTT	万维网
tubo	管
tuj	马上，立刻
tuko	布，巾，布料
tulio	铥
tulipfloro	郁金香花，郁金香
tulipo	郁金香，郁金香花
tunelo	地道
turisto	观光客
turmenti	欺负，欺
turnakvo	漩涡
turo	车
turto	斑鸠
tusi	咳嗽
Tut-Tera Teksaĵo	万维网
tuta	全，都
tuta mondo	全世界
tuta nomo	全名
tutaj	全，都
tute	全部，完全
tutmonda	全球
tutmondaj	全世界
tutmondigo	全球化
tutnova	崭新
Ŭej-Reĝlando	魏国
ujo	盒子
ulaĉo	鬼
ulmarbo	榆，榆树
ulmo	榆，榆树
ulno	尺骨
ulo	鬼
umbilika ŝnuro	脐带
umbiliko	肚脐，脐
umearbo	梅，梅树
umefloro	梅花
Unesko	联合国教育科学文化组织，联合国教科文组织，教科文组织
ungo	手指甲，脚趾甲
unika	独特
universala ŝraŭbilo	活动扳手
universala ŝraŭbŝlosilo	活动扳手
universitato	大学
universo	宇宙
unu	一
unu la alian	互相…，相互…，互相，相互
unu minuto	一分钟
unua	第一
unua persono	第一人秤
unuafoje	首度
unuafojo	第一次
unuĉelula	单细胞
unuĉelula organismo	单细胞生物
unufoje	一次
unufoje denove	再一次
Unuiĝintaj Nacioj	联合国
unujara	一年生
unujara herbo	一年生草本
unukornulo	独角兽
ununokta afero	一夜情
ununura	独特
unuo	单位
unuoble	一倍
uranio	铀
Urano	天王星，乌拉诺斯
urbdomo	市政府
urbego	都
urbestro	市长
urbeto	城镇
urbo	都，都市，市，城市
urbocentro	市区，市中心
Urduo	乌尔都语
urinveziko	膀，膀胱，胱
urso	熊
urtiko	荨，荨，荨麻，荨麻
Urumĉio	乌鲁木齐
utera cerviko	子宫颈
utero	子宫
utila	好用
Ŭu-Reĝlando	吴国
uvulo	小舌
uzanto	用户
uzi	采用，吸，使用，用
uzi drogojn	吸毒
uzo	用途
vaga nervo	迷走神经
vagi	流浪
vagonaro	列车，火车
vagono	车厢，火车车厢
vagulo	流浪汉
vaksflava	蜡黄
vakskandelo	蜡烛
vakso	蜡
vakstolo	油布
valizo	行李箱
valora	宝贵
valoro	价值
vampiro	吸血鬼
vanado	钒
vango	面颊，颊，脸颊
vangobarbo	络腮胡子
vangofrapi	打耳光，拍击，掴
vangofrapo	耳光，拍击声，掴
vangoharoj	络腮胡子
vangosto	颧骨，颧
vanta	虚荣
vaporo	蒸气
varfo	码头
varma	热，温暖
varmbotelo	热水瓶
varmo	热量
Varsovia Kontrakto	华约组织，华沙条约组织，华约
Varsovia Traktato	华沙条约组织，华约，华约组织
vazlavilo	洗碗机
vazlavmaŝino	洗碗机
vejĉi-ludo	弈，围棋
vejĉio	围棋
vejno	静脉
vekhorloĝo	闹钟
veki	叫醒，吵醒，使人醒来
vekiĝi	醒来，清醒，清醒过来
vendejo	店铺，商店，店
vendi	推销，售卖，售，贩卖，卖，贩
vendi drogojn	贩毒
vendisto	店员，推销员
vendredo	星期五，礼拜五，周五，五
venena gaso	毒气
venena sumako	断肠草，野葛，钩吻
veneni	下毒
veneno	毒，毒药
venĝo	报仇
veni	来
veni de	来自
veni por akompani	迎接
venigi	召唤，召来
venki	打败，赢得
venkiĝi	败仗，被打败
venkinto	胜利者
venko	胜利
venteto	微风
venti	吹风
ventmuelejo	风车
vento	风
ventolilo	电风扇
ventra	腹部的，肚子的
ventriklo	心室
ventro	腹部，肚子
ventrodoloro	肚子痛
ventumi	扇，扇风
ventumilo	扇子，风扇
Venuso	维纳斯，金星
vera	真正，真实
verba finiĝo	动词词尾
verba formo	动词形式
verba frazero	动词短语
verba radiko	动词根
verbo	动词
verda	绿色，绿
vere	真的
vere tre	真的很
vereco	真理
vergi	鞭打
vergo	棒，棍，杖，鞭子
verkisto	作者
vermo	蚓，蚯蚓，蚯
vero	真相，现实，真理
Versajla Packontrakto	凡尔赛和约
verŝajne	大概
verŝi	倒（流体等）
versio	版本
vertebra kolono	脊，脊柱
vertebro	椎骨
vertebrulo	脊椎动物
verukapro	疣猪
veruko	疣
vespermanĝi	吃晚饭
vespermanĝo	晚饭
vespero	晚，晚上
vesperto	蝙蝠，蝠，蝙
vespo	黄蜂
Vesta	维斯塔
vestarko	衣架
Vestfalia Packontrakto	威斯特法伦和约
veŝto	背心
vestoj	衣服
veterinformoj	天气预报
vetero	天气
vetkuri	赛跑
veturigi	开车
veturigi aŭton	开车
veturigisto	驾驶
veturilo	交通工具，车
veziketo	水疱
veziko	气泡，水泡
vi	你们，你
vi mem	你自己，你们自己
vi pravas	你说得对
via	你的…，你们的…
via propra	你们自己的，你自己的，你们自己的
viando	肉
videobendo	录影带
vidi	见，见到，看见，看到
vidpunkto	观念，观点，看法
viktimo	被害人
vilaĝo	村庄
vin	你，你们
vinberarbo	葡萄树，葡萄藤
vindi	包扎，包，裹
vindinfano	婴儿
vindotuko	襁褓
vino	葡萄酒
vintro	冬天，冬
violfloro	紫罗兰，紫罗兰花
violo	紫罗兰，紫罗兰花
violono	小提琴
vipero	毒蛇
vipo	鞭子
vipuro	毒蛇
vir-	雄，公
vira	阳性，雄，公，男性
vira fenikso	凤
vira genro	阳性
vira substantivo	阳性名词
vira vorto	阳性词
virbovo	公牛
virĉevalo	雄马，公马
virino	女人
virkato	公猫
virkoko	公鸡
viro	男人
virŝafo	公羊
virseksa	男性，雄性，雄
virto	道德
viruso	病毒
viŝi	抹，擦
visit	拜访，访问，来访
visko	槲寄生
visterifloro	紫藤花，藤萝，藤萝花，紫藤
visterio	紫藤花，紫藤，藤萝，藤萝花
viŝtuko	抹布
vitro	玻，璃，玻璃
vivaĵo	生物
viveca	活泼
vivi	生活
vivo	生命
vizaĝo	脸，面
viziteti	探望，顺便来访
Vjetnamio	越南
voĉdoni	投票
voĉo	语态
vojaĝanto	旅客
vojaĝi	旅游
vojaĝo	旅行，旅程
vojkruciĝo	路口
vojo	马路，道路
vokala litero	元音字母
vokalo	母音，元音
vokativa kazo	呼格
vokativo	呼格
volframo	钨
voli	想要，要
volo	意志，愿望
volonta	自愿
volonte	愿意
vomi	呕吐
vortaro	字典，词典
vortklaso	词类
vorto	字，词，单字，单词
vortodeveno	语源
vortoj	言语
vortordo	词序，字序
vortprovizo	字汇
vosto	尾，尾巴
Vuhano	武汉
Vulkano	伏尔甘
vulkano	火山
vulpo	狐，狐狸
zebro	斑马
Zeŭso	宙斯
zinko	锌
zirkonio	锆 
zono	皮带
zorga	小心
zorgema	小心
zorgi	管，介意
